ID,Institution,State,cares.act,omnibus,american.rescue.act,total,endowment,president.salary
108100,Arizona State University,AZ,63533137,112906424,197920000,374359561,922000000,1150361
150600,Miami Dade College,FL,49074737,100313671,175095000,324483408,486000000,500000
395400,University Of Central Florida,FL,51071250,88785992,155326000,295183242,162000000,537000
332900,Pennsylvania State University (The),PA,54994846,84967674,149782000,289744520,4000000000,1118247
262900,"Rutgers, The State University Of New Jersey",NJ,54160640,83956947,147525000,285642587,1476000000,870644
991700,Ivy Tech Community College Of Indiana,IN,33040571,87521884,154176000,274738455,0,385000
157400,Georgia State University,GA,45243852,81991625,143227000,270462477,170800000,2806500
115300,"California State University, Northridge",CA,44652328,74004088,128804000,247460416,119000000,486000
963500,Florida International University,FL,38301957,70899027,124068000,233268984,218700000,746600
113700,"California State University, Fullerton",CA,41021512,67736949,118108000,226866461,81700000,509194
113900,"California State University, Long Beach",CA,41729439,67421424,117424000,226574863,79400000,489509
309000,Ohio State University (The),OH,42885215,65158493,115136000,223179708,5290000000,1400000
363200,Texas A&M University,TX,39816443,61084220,108020000,208920663,13514528000,1600000
114000,"California State University, Los Angeles",CA,37914166,61905561,107504000,207323727,46200000,536073
365200,University Of Houston,TX,36703283,61804527,108166000,206673810,960000000,1164000
1063300,Houston Community College,TX,28294391,64722987,113378000,206395378,10200000,329000
379800,University Of Washington - Seattle,WA,39715956,59684404,105672000,205072360,6000000000,950000
1114500,Lone Star College System,TX,28823255,63217876,111568000,203609131,0,0
115000,California State University - Sacramento,CA,35734362,59891260,104257000,199882622,51200000,525038
153700,University Of South Florida,FL,34839748,58187541,102066000,195093289,532000000,575000
359900,University Of Texas - Rio Grande Valley,TX,34334258,58007276,100923000,193264534,46130000,680000
675000,Valencia College,FL,27682203,59512739,104037000,191231942,72500000,320000
150000,Broward College,FL,27154901,58986552,103056000,189197453,62200000,380000
131400,"University Of California, Irvine",CA,36731629,54737221,95771000,187239850,1030000000,890000
131500,"University Of California, Los Angeles",CA,35906870,52623807,92570000,181100677,5390000000,890000
131700,"University Of California, San Diego",CA,34889769,52015747,91170000,178075516,2300000000,890000
269100,Cuny Borough Of Manhattan Community College,NY,26420828,55218492,95999000,177638320,0,0
114700,"California State University, Fresno",CA,32802107,52725317,91631000,177158424,170800000,632000
131300,"University Of California, Davis",CA,33871763,51521569,90298000,175691332,1660000000,890000
361500,Texas State University,TX,31791509,52142552,91252000,175186061,95400000,525000
367000,Brigham Young University,UT,32272986,50333740,88121000,170727726,1970000000,299300
153500,University Of Florida,FL,31046411,49578739,87513000,168138150,1850000000,926000
1011500,University Of Texas At San Antonio,TX,29656887,49567034,86529000,165752921,172000000,
365800,University Of Texas At Austin,TX,31462321,48376958,85475000,165314279,30100000000,
114400,"California State Polytechnic University, Pomona",CA,30904089,48614353,84673000,164191442,101599000,
108300,University Of Arizona,AZ,30953447,47971859,84385000,163310306,1038133000,
359400,University Of North Texas,TX,29018088,47854595,83851000,160723683,210624000,
362600,Tarrant County College District,TX,21984486,49701915,87484000,159170401,,
115400,San Francisco State University,CA,28725948,47404409,82743000,158873357,137080000,
177600,University Of Illinois,IL,29874590,47074555,81725000,158674145,2353821000,
131600,"University Of California, Riverside",CA,29734626,46440300,80888000,157062926,259800000,
115500,San Jose State University,CA,28769546,46631939,81613000,157014485,153212000,
229000,Michigan State University,MI,29836588,45964753,80773000,156574341,3033279000,
157700,Kennesaw State University,GA,27911927,46559603,81512000,155983530,40300000,
131200,"University Of California, Berkeley",CA,30440627,45429825,80102000,155972452,2070905000,
115100,San Diego State University,CA,29394934,45914127,80465000,155774061,353334000,
177500,University Of Illinois ,IL,31448178,44619241,79046000,155113419,2353821000,
148900,Florida State University,FL,29339828,45382413,79899000,154621241,704106000,
337100,Temple University,PA,28740378,44242362,77788000,150770740,644089000,
402700,Utah Valley University,UT,22949207,45611519,79919000,148479726,34800000,
366100,University Of Texas At El Paso,TX,24827599,43769137,76258000,144854736,241700000,
114200,"California State University, San Bernardino",CA,26243781,42438131,73768000,142449912,44900000,
372700,Northern Virginia Community College,VA,20028703,44142743,77919000,142090446,0,
396900,University Of Minnesota,MN,25794123,40211125,71645000,137650248,3951464000,
3103400,South Texas College,TX,20022398,42189602,73775000,135987000,0,
364400,Texas Tech University,TX,25515252,39788865,69984000,135288117,1316660000,
2151900,Keiser University,FL,21190626,41666816,71133000,133990442,0,
297500,University Of North Carolina at Charlotte,NC,24310557,39537542,69257000,133105099,230352000,
312500,University Of Cincinnati,OH,23527312,39288631,69416000,132231943,1453000000,
148100,Florida Atlantic University,FL,22429874,39909756,69874000,132213630,227520000,
151200,Palm Beach State College,FL,18933435,40897446,71541000,131371881,19300000,
256900,University Of Nevada,NV,23685293,38673077,67843000,130201370,377446000,
132000,"University Of California, Santa Barbara",CA,25204196,38078709,66653000,129935905,403000000,
278500,New York University,NY,25626944,37413437,66798000,129838381,4345608000,
1171900,Universidad Ana G. Méndez - Gurabo Campus,PR,21074293,37352341,70523000,128949634,263000000,
365600,University Of Texas At Arlington,TX,21177188,38549079,67807000,127533267,159000000,
108200,Northern Arizona University,AZ,23577854,37511826,65713000,126802680,192621000,
232500,University Of Michigan,MI,25244052,36174408,64414000,125832460,12448817000,920290
180900,Indiana University ,IN,24572922,35998136,63810000,124381058,2486037000,
283700,State University Of New York At Buffalo,NY,23952900,36082991,63486000,123521891,794000000,
157200,Georgia Southern University,GA,22748221,36537745,63946000,123231966,56324000,
159800,University Of Georgia,GA,23704129,35659597,63171000,122534726,1343987000,
374900,George Mason University,VA,20855024,36198204,63918000,120971228,113199000,
305100,Kent State University,OH,19307244,36699722,64739000,120745966,141403000,
2053000,Liberty University,VA,15205124,37777577,66300000,119282701,1587919000,
162500,Brigham Young University Idaho,ID,18172623,36367051,63904000,118443674,103000000,
380000,Washington State University,WA,21768544,34967964,61437000,118173508,1067842000,
1038700,El Paso Community College,TX,16590145,36278737,63448000,116316882,0,
182500,Purdue University,IN,22588795,33443017,59581000,115612812,2625278000,
181300,Indiana University - Purdue University Indianapolis,IN,20919345,33894635,59581000,114394980,691300000,
210300,"University Of Maryland, College Park",MD,21490713,32838845,58245000,112574558,1436000000,
787000,Hillsborough Community College,FL,16262267,34912041,61096000,112270308,7219000,
124500,Mount San Antonio College,CA,17457959,34267707,60168000,111893666,0,
186900,Iowa State University Of Science and Technology,IA,21698857,32442265,57329000,111470122,1101709000,
268900,Cuny Hunter College,NY,19006958,33557126,58696000,111260084,136000000,
141700,University Of Connecticut,CT,21500845,32098504,56616000,110215349,462375000,
232900,Wayne State University,MI,19306183,32377451,56885000,108568634,394509000,
373500,Virginia Commonwealth University,VA,20288998,31937228,56234000,108460226,2042520000,
344800,University Of South Carolina,SC,21415130,31224416,55306000,107945546,788261000,
105100,University Of Alabama,AL,20722538,31436739,55688000,107847277,1519595000,
261700,Montclair State University,NJ,19911482,31667908,55356000,106935390,79490000,
114600,"California State University, Chico",CA,19959391,31603856,55070000,106633247,62900000,
1036200,College Of Southern Nevada,NV,14078408,33500005,58831000,106409413,6160000,
337900,University Of Pittsburgh,PA,21265340,30614591,54308000,106187931,4311387000,
114100,"California State University, Dominguez Hills",CA,18481277,31843563,55383000,105707840,12543000,
258000,Southern New Hampshire University,NH,5494008,36406842,63789000,105689850,16700000,
1201500,Austin Community College,TX,13907800,32959121,58237000,105103921,0,
382700,West Virginia University,WV,20174232,30727088,54131000,105032320,611300000,
394400,University Of Puerto Rico - Mayaguez,PR,19658125,31050892,53894000,104603017,256000000,
367500,University Of Utah,UT,18725330,30775179,54368000,103868509,1225045000,
283800,State University Of New York At Stony Brook,NY,19710714,30468755,53591000,103770469,265000000,
974100,University Of Texas At Dallas,TX,19132188,30612137,53908000,103652325,603000000,
292300,East Carolina University,NC,19358758,30548181,53586000,103492939,212566000,
324900,Community College Of Philadelphia,PA,16102431,31849546,55421000,103372977,0,
268700,Cuny Brooklyn College,NY,17627330,31206205,54429000,103262535,86100000,
148400,Florida State College At Jacksonville,FL,14500515,32230437,56479000,103209952,41000000,
266300,University Of New Mexico,NM,17266512,31124648,54682000,103073160,457313000,
389500,University Of Wisconsin,WI,19783001,29783409,53184000,102750410,3152578000,
132800,University Of Southern California,CA,19278560,29961264,53492000,102731824,5732101000,
367700,Utah State University,UT,17428745,30735450,53875000,102039195,402862000,
310000,Ohio University,OH,19475431,29578885,52303000,101357316,580657000,
297600,University Of North Carolina Greensboro,NC,18567881,30132331,52590000,101290212,310300000,
321600,Portland State University,OR,16640405,30740104,53908000,101288509,80341000,
269600,New York City College Of Technology Of The City University Of New York,NY,16209328,30860066,53731000,100800394,12000000,
353000,University Of Tennessee,TN,19258313,29330189,51731000,100319502,1354756000,
2587500,Universidad Ana G. Méndez - Cupey Campus,PR,17052692,29487643,53314000,99854335,263000000,
201000,Louisiana State University Agricultural & Mechanical College,LA,18882288,29264189,51689000,99835477,521800000,
132100,"University Of California, Santa Cruz",CA,19327201,28784842,50385000,98497043,215400000,
137000,University Of Colorado,CO,18732408,28660299,50917000,98309707,1452722000,
226800,Grand Valley State University,MI,18333428,28990835,50943000,98267263,132091000,
126100,Pasadena City College,CA,15230050,30076671,52854000,98160721,0,
269000,Cuny Queens College,NY,16736798,29491179,51556000,97783977,85000000,
121900,Long Beach City College,CA,14663058,30001059,52555000,97219117,15000000,
351000,Middle Tennessee State University,TN,17299411,28959281,50677000,96935692,105575000,
375400,Virginia Tech,VA,19398987,27790518,49426000,96615505,1357969000,
360600,Sam Houston State University,TX,17468204,28732181,50220000,96420385,116921000,
222100,University Of Massachusetts,MA,18335243,28151583,49744000,96230826,881302000,
135000,Colorado State University,CO,17693711,28296524,50028000,96018235,376063000,
297200,NC State University,NC,17895881,28156562,49914000,95966443,1400655000,
389600,University Of Wisconsin - Milwaukee,WI,16925665,28243310,50220000,95388975,263000000,
318400,University Of Oklahoma,OK,17935530,27880322,49305000,95120852,1736000000,
321300,Portland Community College,OR,12538743,29787645,52676000,95002388,0,
727300,Cuny Bernard M. Baruch College,NY,16563226,28496963,49783000,94843189,220000000,
209900,Towson University,MD,17335851,27802351,48800000,93938202,83500000,
265700,New Mexico State University,NM,14076359,27692217,51955000,93723576,182676000,
242300,Mississippi State University,MS,17856107,27549415,48318000,93723522,528679000,
710800,University Of Puerto Rico - Rio Piedras Campus,PR,16873620,27909114,48778000,93560734,127000000,
152800,St. Petersburg College,FL,12813482,29077189,50850000,92740671,57400000,
198900,University Of Kentucky,KY,17811058,26729420,47204000,91744478,1407221000,
686700,Columbus State Community College,OH,12562800,28667248,50509000,91739048,0,
111800,Bakersfield College,CA,12182994,28817459,50541000,91541453,0,
269300,Cuny John Jay College Of Criminal Justice,NY,15320009,27635844,48174000,91129853,0,
350900,University of Memphis,TN,15603749,27375611,47862000,90841360,220800000,
268800,City College Of New York - Cuny,NY,15399906,27101618,47252000,89753524,264000000,
321000,Oregon State University,OR,15559998,26602486,46974000,89136484,622473000,
1005100,Cuny Laguardia Community College,NY,12917232,27737337,48436000,89090569,6200000,
3011300,"California State University, San Marcos",CA,15963036,26602684,46376000,88941720,27900000,
372800,Old Dominion University,VA,15548901,26643627,46649000,88841528,261711000,
297400,University Of North Carolina at Chapel Hill,NC,17295177,25474540,45165000,87934717,3671351000,
2226000,East Los Angeles College,CA,10797043,27863000,49235000,87895043,0,
394100,Universidad Ana G. Méndez - Carolina Campus,PR,14212207,25568181,47479000,87259388,0,
136000,Metropolitan State University Of Denver,CO,14390083,26366088,46146000,86902171,0,
189200,University Of Iowa,IA,16171354,24985012,44971000,86127366,1578933000,
116300,Chaffey Community College,CA,11446484,27096162,47539000,86081646,0,
916300,San Antonio College,TX,7648254,17950364,60168000,85766618,0,
283500,State University Of New York At Albany,NY,16063982,25189865,44087000,85340847,77700000,
169200,Illinois State University,IL,16121422,24967651,43834000,84923073,144435000,
130700,Fresno City College,CA,11224898,26689998,46894000,84808896,0,
371200,Tidewater Community College,VA,11999956,26394906,46174000,84568862,0,
251600,University Of Missouri,MO,16309144,24612553,43572000,84493697,1743142000,
702200,Cuny Lehman College,NY,13293096,25866919,45102000,84262015,0,
233000,Western Michigan University,MI,15486304,24878439,43702000,84066743,404653000,
287800,Suffolk County Community College,NY,13179539,25567624,44966000,83713163,0,
116100,Cerritos Community College,CA,12186449,25937610,45394000,83518059,0,
123200,American River College,CA,10613663,26247243,46362000,83222906,0,
322300,University Of Oregon,OR,16095946,24150869,42587000,82833815,912000000,
462500,Delgado Community College,LA,11310381,26068215,45345000,82723596,0,
290600,Appalachian State University,NC,15927932,24036104,42174000,82138036,122400000,
256500,University Of Nebraska,NE,15628700,23871084,42162000,81661784,1435753000,
110800,University Of Arkansas,AR,15454361,23908298,42289000,81651659,1221935000,
113800,"California State University, East Bay",CA,14617347,24243652,42317000,81177999,0,
119700,El Camino College,CA,11659979,25121457,44176000,80957436,0,
128600,Santa Monica College,CA,12193513,24643186,43542000,80378699,0,
173700,Northern Illinois University,IL,14825179,23728409,41518000,80071588,80065000,
213000,Boston University,MA,14995316,23192730,41556000,79744046,2304235000,
244000,University Of Mississippi,MS,16642638,22812460,40263000,79718098,736288000,
4142900,Georgia Gwinnett College,GA,13470330,24155260,42048000,79673590,0,
158500,University Of North Georgia,GA,13636481,23881394,41865000,79382875,55600000,
194800,Kansas University,KS,15189645,23072146,40884000,79145791,1816931000,
127000,Riverside City College,CA,10831532,24611165,43151000,78593697,0,
250300,Missouri State University,MO,13855674,23441360,41239000,78536034,145800000,
260900,Rowan University,NJ,14471695,23165569,40676000,78313264,232094000,
368000,Weber State University,UT,11714226,24098981,42489000,78302207,150522000,
225900,Eastern Michigan University,MI,13733990,23256060,40832000,77822050,78171000,
178600,Ball State University,IN,15246930,22465635,39765000,77477565,212834000,
522000,Salt Lake Community College,UT,10647873,24130769,42580000,77358642,0,
312300,University Of Akron,OH,14151817,22879071,40198000,77228888,235962000,
167100,Depaul University,IL,14373219,22684440,39976000,77033659,696452000,
2361400,Collin County Community College,TX,10790912,23826101,42319000,76936013,0,
224300,Central Michigan University,MI,14322194,22642806,39780000,76745000,189322000,
290500,North Carolina Agricultural & Technical State University,NC,14103628,22848969,39774000,76726597,73800000,
269700,Queensborough Community College-Cuny,NY,11321080,23701583,41362000,76384663,0,
262200,Kean University,NJ,13509139,22855391,39893000,76257530,0,
256800,"University Of Nevada , Reno",NV,14244534,22437606,39517000,76199140,367500000,
799300,"California State University, Bakersfield",CA,13588942,22855632,39754000,76198574,25474000,
230700,Oakland University,MI,13796824,22347727,39264000,75408551,99399000,
360900,San Jacinto Community College District,TX,8950463,23826057,42022000,74798520,0,
691100,Montgomery College,MD,10995749,23080761,40556000,74632510,0,
325600,Drexel University,PA,13179268,21945057,39438000,74562325,813685000,
269800,College Of Staten Island/Cuny,NY,12595956,22565946,39350000,74511902,0,
304000,Cuyahoga Community College,OH,10027370,23257012,40795000,74079382,0,
115700,"California State University, Stanislaus",CA,13314715,22007207,38261000,73582922,0,
340400,Johnson & Wales University,RI,14182680,21525278,37558000,73265958,0,
363000,Prairie View Agricultural & Mechanical University,TX,13752928,21681605,37676000,73110533,0,
313100,University Of Toledo,OH,13547254,21572302,37917000,73036556,454114000,
3026500,Remington College,TX,13408868,21585012,37725000,72718880,0,
244100,University Of Southern Mississippi,MS,13506042,21475374,37492000,72473416,104878000,
726600,Pima County Community College,AZ,9989049,22597292,39694000,72280341,0,
287300,Nassau Community College,NY,12022119,21854649,38330000,72206768,0,
291500,Central Piedmont Community College,NC,10787553,22154356,38852000,71793909,33276000,
114300,California Polytechnic State University,CA,14095976,20752799,36681000,71529775,227700000,
301800,Bowling Green State University,OH,13163417,21124710,37162000,71450127,149438000,
222200,University Of Massachusetts,MA,12184652,21381281,37440000,71005933,881302000,
269400,Kingsborough Commmunity College/Cuny,NY,10156521,22157742,38688000,71002263,0,
484400,Wake Technical Community College,NC,10390849,21750983,38154000,70295832,0,
340800,Community College Of Rhode Island,RI,10000569,21958065,38309000,70267634,0,
148000,Florida Agricultural & Mechanical University,FL,13051325,20845563,36273000,70169888,95600000,
393600,Pontifical Catholic University Of Puerto Rico (The),PR,12669949,20974546,36417000,70061495,0,
342500,Clemson University,SC,13579995,20323247,36093000,69996242,774514000,
283600,Binghamton University,NY,13607332,20273531,35679000,69559863,0,
111300,Antelope Valley College,CA,10245691,21580696,37647000,69473387,0,
203100,University Of Louisiana At Lafayette,LA,12686007,20614028,36119000,69419035,153000000,
269200,Cuny Bronx Community College,NY,9658626,21655807,37641000,68955433,0,
199900,University Of Louisville,KY,12478790,20434285,36008000,68921075,719816000,
307700,Miami University,OH,12989033,19996909,35489000,68474942,560965000,
474200,Central New Mexico Community College,NM,9305433,21404465,37661000,68370898,0,
4127100,"University Of California, Merced",CA,13037897,20217509,35115000,68370406,0,
363400,Texas State Technical College,TX,9965155,21292313,37108000,68365468,0,
206300,Community College Of Baltimore County,MD,9349870,21419784,37525000,68294654,0,
303200,Cleveland State University,OH,12226765,20280093,35553000,68059858,0,
161600,Boise State University,ID,10937516,20644600,36458000,68040116,115056000,
105200,University Of Alabama At Birmingham,AL,12131256,20190148,35527000,67848404,537300000,
327300,Harrisburg Area Community College,PA,9105781,21319018,37300000,67724799,0,
354900,Blinn College,TX,14141911,19342202,33875000,67359113,0,
890600,Macomb Community College,MI,9617297,20872067,36647000,67136364,0,
984100,University Of North Florida,FL,11770196,20011442,35124000,66905638,116186000,
124000,Modesto Junior College,CA,9575504,20615809,36120000,66311313,0,
665600,College Of Du Page,IL,9100886,20581172,36504000,66186058,0,
120100,Fullerton College,CA,9700734,20180789,35604000,65485523,0,
386600,Milwaukee Area Technical College,WI,8505373,20700673,36160000,65366046,0,
364200,Texas Southern University,TX,11796898,19514520,33957000,65268418,59400000,
240700,Hinds Community College,MS,10520779,19910506,34710000,65141285,0,
124600,Mt. San Jacinto College,CA,9713109,20043399,35128000,64884508,0,
271100,Cornell University,NY,12800980,18512730,33049000,64362710,7328241000,
315200,University Of Central Oklahoma,OK,11170390,19306609,33801000,64277999,0,
219900,Northeastern University,MA,11648813,18744880,33705000,64098693,1055474000,
270700,Columbia University In The City Of New York,NY,12830199,18314873,32952000,64097072,10950738000,4518000
287200,Monroe Community College,NY,9166962,19927127,34921000,64015089,0,
149300,Indian River State College,FL,9553094,19691247,34501000,63745341,0,
129400,Southwestern Community College District,CA,9253264,19762638,34712000,63727902,0,
450800,University Of Colorado Denver,CO,10184083,19226923,34108000,63519006,593000000,
332800,West Chester University Of Pennsylvania,PA,11992115,18645808,32820000,63457923,0,
247100,Saint Louis Community College,MO,8727263,19785083,34748000,63260346,0,
202400,Southeastern Louisiana University,LA,10580284,18997836,33266000,62844120,0,
120300,Glendale Community College,CA,10056959,19042328,33641000,62740287,0,
200200,Western Kentucky University,KY,10636493,18748413,32954000,62338906,175186000,
3255300,Florida Gulf Coast University,FL,11143620,18572907,32567000,62283527,84600000,
143100,University Of Delaware,DE,12174809,18010638,32080000,62265447,1466070000,
227000,Henry Ford College,MI,9153117,19312149,33712000,62177266,0,
147700,Florida Southwestern State College,FL,9178997,19237570,33689000,62105567,0,
123300,Sacramento City College,CA,7946038,19563511,34491000,62000549,0,
160100,University Of West Georgia,GA,10881459,18585785,32491000,61958244,0,
380200,Western Washington University,WA,11641693,18228534,31969000,61839227,77349000,
1037400,Metropolitan State University,MN,5159002,10533046,46146000,61838048,6017000,
372100,James Madison University,VA,12080658,17880192,31758000,61718850,111065000,
105700,University Of South Alabama,AL,11408535,18170202,31876000,61454737,383512000,
1172700,Delaware Technical Community College,DE,9008399,19085686,33348000,61442085,0,
196300,Eastern Kentucky University,KY,10542767,18411187,32230000,61183954,69139000,
107600,Glendale Community College,AZ,8301836,19156542,33641000,61099378,0,
363100,Tarleton State University,TX,10893519,18126764,31698000,60718283,0,
248400,Metropolitan Community College,MO,8709049,18839455,33027000,60575504,0,
348700,East Tennessee State University,TN,11096758,17943833,31435000,60475591,127684000,
255400,University Of Nebraska At Omaha,NE,10759273,18001689,31576000,60336962,71600000,
347800,Austin Peay State University,TN,9687866,18455648,32177000,60320514,0,
161000,University Of Hawaii At Manoa,HI,11009867,17701585,31212000,59923452,327000000,
192800,Kansas State University,KS,12686554,19845018,27357000,59888572,510300000,
341400,University Of Rhode Island,RI,11238683,17440405,30786000,59465088,149154000,
361200,University Of Houston - Downtown,TX,9456650,18182989,31758000,59397639,0,
147000,Eastern Florida State College,FL,8816361,18346823,32087000,59250184,0,
125000,Orange Coast College,CA,9120468,18102486,31971000,59193954,0,
258900,University Of New Hampshire,NH,11647555,17118551,30232000,58998106,803867000,
374500,University Of Virginia,VA,11716710,16866806,30229000,58812516,7058235000,
976300,Tulsa Community College,OK,7980293,18390355,32212000,58582648,0,
314500,Youngstown State University,OH,10376462,17353182,30357000,58086644,279778000,
307800,Wright State University,OH,10140846,17372092,30558000,58070938,97080000,
137100,University Of Denver,CO,4626269,7105908,46146000,57878177,786425000,
284200,Suny College At Buffalo,NY,10484417,17271471,30077000,57832888,0,
288200,Syracuse University,NY,9920122,17139335,30741000,57800457,1392691000,
311900,Sinclair Community College,OH,7434204,18192393,32046000,57672597,30718000,
362400,Stephen F Austin State University,TX,10525078,17133422,29973000,57631500,0,
152000,Seminole State College Of Florida,FL,8150059,17960733,31497000,57607792,0,
1121000,Bunker Hill Community College,MA,8310307,17939271,31347000,57596578,0,
280600,Rochester Institute Of Technology,NY,10380480,17026233,29972000,57378713,944883000,
298400,University Of North At Carolina Wilmington (The),NC,10566053,16948600,29804000,57318653,104000000,
118600,College Of The Sequoias,CA,8630859,17686139,30894000,57210998,0,
323100,Community College Of Allegheny County,PA,7987479,17789944,31264000,57041423,0,
107700,Mesa Community College,AZ,7352103,17795363,31352000,56499466,0,
156900,Georgia Institute Of Technology,GA,10388077,16463107,29480000,56331184,2169005000,
377500,Eastern Washington University,WA,9986299,16721122,29327000,56034421,24195000,
965100,Texas A&M International University,TX,9501756,16965643,29504000,55971399,0,
1116100,Texas A&M University - Corpus Christi,TX,10105662,16650317,29147000,55902979,0,
253200,Montana State University,MT,10560079,16378060,28909000,55847139,180168000,
133500,Victor Valley Community College,CA,8067843,17276235,30171000,55515078,0,
1295400,Hudson County Community College,NJ,8467661,17156604,29847000,55471265,0,
122600,Los Angeles Pierce College,CA,7694796,17269929,30374000,55338725,0,
126000,Palomar College,CA,7702862,17131625,30395000,55229487,0,
3083000,Ozarks Technical Community College,MO,7950662,17034808,29731000,54716470,0,
262500,William Paterson University Of New Jersey,NJ,9763356,16326775,28497000,54587131,0,
114900,Humboldt State University,CA,10302998,16130016,28056000,54489014,30294000,
473600,Bergen Community College,NJ,8461418,16666659,29228000,54356077,0,
354500,Baylor University,TX,10777489,15704656,27828000,54310145,1340417000,
128000,San Joaquin Delta College,CA,7835430,16847806,29616000,54299236,0,
712000,Des Moines Area Community College,IA,7345999,16915417,30001000,54262416,0,
180700,Indiana State University,IN,9566914,16123384,28215000,53905298,67714000,
226000,Ferris State University,MI,9146813,16169673,28320000,53636486,87355000,
100900,Auburn University,AL,15645745,23036339,14878000,53560084,792983000,
1164400,University Of Maryland Global Campus,MD,5210563,17500109,30845000,53555672,0,
104700,Troy University,AL,8544084,16265960,28482000,53292044,129192000,
171000,Loyola University,IL,10043948,15534548,27467000,53045496,692166000,
159900,Valdosta State University,GA,9331398,15904262,27784000,53019660,0,
1258600,Metropolitan Community College,NE,5767395,14067027,33027000,52861422,0,
129000,Sierra College,CA,7595581,16340166,28802000,52737747,0,
934500,Stockton University,NJ,10041238,15511416,27132000,52684654,0,
230300,Oakland Community College,MI,7474366,16298327,28758000,52530693,0,
345100,Coastal Carolina University,SC,10054347,15415915,26975000,52445262,51483000,
175900,Southern Illinois University Edwardsville,IL,9678393,15509840,27230000,52418233,26568000,
889600,Pikes Peak Community College,CO,7543778,16312451,28549000,52405229,0,
147500,Daytona State College,FL,7681731,16243172,28420000,52344903,0,
327700,Indiana University Of Pennsylvania,PA,10050461,15342227,26877000,52269688,7615000,
450200,City College Of San Francisco,CA,7009874,16223115,28984000,52216989,0,
109000,Arkansas State University,AR,9258158,15575949,27357000,52191107,84430000,
109200,University Of Central Arkansas,AR,9604924,15456600,27055000,52116524,0,
352200,Tennessee State University,TN,7214661,13306383,31435000,51956044,127684000,
216100,University Of Massachusetts - Lowell,MA,8900322,15481101,27285000,51666423,100000000,
126900,Rio Hondo Community College,CA,6232775,16317598,28860000,51410373,0,
483800,Guilford Technical Community College,NC,8260390,15718356,27393000,51371746,0,
793300,Front Range Community College,CO,7046470,16023686,28248000,51318156,0,
923000,Wayne County Community College District,MI,6158090,16399714,28688000,51245804,0,
210500,University Maryland,MD,9315657,15200168,26720000,51235825,232473000,
861100,"Cuny, Hostos Community College",NY,7267430,16037693,27864000,51169123,0,
352900,University Of Tennessee - Chattanooga,TN,9513779,15131381,26509000,51154160,0,
1043900,Southwest Tennessee Community College,TN,7298437,15887215,27671000,50856652,0,
120800,Grossmont College,CA,7141562,15800280,27833000,50774842,0,
364600,Texas Woman'S University,TX,8683388,15250810,26807000,50741198,79577000,
153300,Tallahassee Community College,FL,7763584,15548981,27210000,50522565,0,
151900,Santa Fe College,FL,7859449,15471315,27163000,50493764,0,
128400,Santa Ana College,CA,5594396,16096029,28797000,50487425,0,
119300,Cypress College,CA,7147934,15639532,27506000,50293466,0,
358200,Laredo College,TX,8926222,15039999,26316000,50282221,0,
195000,Wichita State University,KS,8786465,14991432,26317000,50094897,276142000,
137800,Central Connecticut State University,CT,9009014,14879577,26085000,49973591,0,
121400,Imperial Valley College,CA,4995150,16249873,28275000,49520023,0,
3372300,Northwest Vista College,TX,6926619,15424223,27149000,49499842,0,
381500,Marshall University,WV,9003939,14679980,25792000,49475919,140181000,
236000,"Minnesota State University, Mankato",MN,9088962,14617272,25760000,49466234,0,
298100,Western Carolina University,NC,8893407,14719306,25761000,49373713,88701000,
100200,Alabama Agricultural & Mechanical University,AL,9121201,14519790,25215000,48855991,0,
364800,Tyler Junior College,TX,7395647,15043429,26340000,48779076,0,
261500,Middlesex County College,NJ,7378634,14976713,26245000,48600347,0,
241700,Mississippi Gulf Coast Community College,MS,7880280,14832095,25873000,48585375,0,
399300,Midlands Technical College,SC,7332783,15009166,26197000,48538949,9289000,
710700,Essex County College,NJ,7752662,14868024,25891000,48511686,0,
218300,Bridgewater State University,MA,8833662,14374448,25299000,48507110,0,
208300,Morgan State University,MD,9263592,14278129,24877000,48418721,0,
295000,North Carolina Central University,NC,8932233,14295567,24908000,48135800,0,
215500,Harvard University,MA,8655748,13992069,25453000,48100817,39427896000,570000
288100,Suny Westchester Community College,NY,7195672,14856758,25985000,48037430,0,
317000,Oklahoma State University,OK,16765725,26166701,4988000,47920426,0,
1068400,Erie Community College,NY,7995845,14464959,25390000,47850804,0,
264300,Union County College,NJ,7393008,14722903,25706000,47821911,0,
116600,Citrus College,CA,7429415,14643671,25731000,47804086,0,
144400,George Washington University,DC,9118529,13793324,24768000,47679853,1778559000,
115600,Sonoma State University,CA,9093447,13980795,24453000,47527242,52281000,
373200,Radford University,VA,9092203,14055735,24359000,47506938,56080000,
226700,Grand Rapids Community College,MI,6806171,14722172,25851000,47379343,0,
261300,New Jersey City University,NJ,8337070,14225979,24790000,47353049,0,
122800,Los Angeles Valley College,CA,6154624,14883877,26161000,47199501,0,
450900,University Of Colorado Colorado Springs,CO,7925645,14140787,24876000,46942432,0,
118200,College Of The Desert,CA,7061346,14500076,25357000,46918422,0,
208900,Prince George'S Community College,MD,6421788,14714347,25763000,46899135,0,
175800,Southern Illinois University At Carbondale,IL,8866635,13756851,24136000,46759486,0,
448000,De Anza Community College,CA,7235258,14159017,25192000,46586275,0,
147900,Embry-Riddle Aeronautical University,FL,6845716,14390767,25327000,46563483,161405000,
890300,College Of The Canyons,CA,6326734,14427200,25722000,46475934,0,
769200,Moraine Valley Community College,IL,6465543,14452872,25493000,46411415,0,
262100,New Jersey Institute Of Technology,NJ,8110969,13798201,24200000,46109170,129455000,
127200,San Bernardino Valley College,CA,6732563,14257809,25044000,46034372,0,
352300,Tennessee Technological University,TN,8713463,13533046,23687000,45933509,0,
927500,Northern Kentucky University,KY,7998963,13713911,24131000,45843874,105501000,
140600,Southern Connecticut State University,CT,8390168,13594612,23804000,45788780,30520000,
337800,University Of Pennsylvania,PA,9907683,14600409,21259000,45767092,14649762000,3069200
241000,Jackson State University,MS,8446248,13577858,23631000,45655106,0,
475900,Cuny York College,NY,7205414,14007349,24431000,45643763,0,
237700,St. Cloud State University,MN,7821764,13652272,24024000,45498036,0,
119100,Diablo Valley College,CA,6679277,13947135,24804000,45430412,0,
3260300,"California State University, Monterey Bay",CA,8459727,13455716,23461000,45376443,0,
1065200,Pasco - Hernando State College,FL,6574907,13965491,24418000,44958398,0,
392600,University Of Wisconsin - Whitewater,WI,8169773,12907818,23878000,44955591,0,
3730300,Baton Rouge Community College,LA,6420025,14020032,24419000,44859057,0,
377100,Central Washington University,WA,7695384,13588432,23572000,44855816,0,
127500,San Diego Mesa College,CA,5911519,13992119,24888000,44791638,0,
123700,Merced Community College,CA,6536491,13763999,24120000,44420490,0,
1009700,Cuny Medgar Evers College,NY,7109437,13615664,23689000,44414101,0,
399100,Greenville Technical College,SC,6663667,13723584,23994000,44381251,0,
279100,Pace University,NY,8562106,12938858,22868000,44368964,193049000,
173900,Northwestern University,IL,8521175,12775920,22993000,44290095,11091516000,
492000,Trident Technical College,SC,6568275,13700146,24010000,44278421,0,
407600,Kirkwood Community College,IA,6336610,13718324,24116000,44170934,0,
2141500,Savannah College Of Art And Design,GA,8209651,12972158,22938000,44119809,0,
144800,Howard University,DC,8723244,12747281,22324000,43794525,692832000,
122700,Los Angeles Trade-Technical College,CA,5124229,13850786,24378000,43353015,0,
458600,Purdue University Global,IN,816781,15423168,27103000,43342949,0,
178000,Western Illinois University,IL,7997093,12857820,22455000,43309913,0,
500000,Pierce College,WA,3925203,8964719,30374000,43263922,0,
162000,Idaho State University,ID,7097839,13094512,23001000,43193351,0,
753600,Cosumnes River College,CA,5574947,13570233,23910000,43055180,0,
151400,Polk State College,FL,6116050,13292541,23258000,42666591,0,
284800,Suny College At Oswego,NY,7244716,12886557,22508000,42639273,0,
358100,Lamar University,TX,7048774,12878096,22641000,42567870,26222000,
251800,University Of Missouri - Kansas City,MO,7062723,12791149,22638000,42491872,0,
134900,University Of Northern Colorado,CO,7650214,12601749,22205000,42456963,89775000,
764000,Fayetteville Technical Community College,NC,5913774,13276771,23217000,42407545,0,
128700,Santa Rosa Junior College,CA,5942841,13114035,23333000,42389876,0,
108900,Arkansas Tech University,AR,7098986,12806406,22408000,42313392,0,
1014200,Touro College,NY,7558879,12565306,22146000,42270185,0,
356500,Texas A&M University - Commerce,TX,7193156,12743661,22316000,42252817,0,
284100,Suny College At Brockport,NY,7750148,12461885,21778000,41990033,0,
253600,University Of Montana (The),MT,7652275,12405952,21796000,41854227,0,
272200,Fordham University,NY,8147184,12071949,21532000,41751133,733516000,
205300,University Of Maine,ME,7603694,12814741,21233000,41651435,227085000,
122300,Los Angeles City College,CA,5197272,13476393,22846000,41519665,0,
719100,Northampton County Area Community College,PA,6039116,12847473,22454000,41340589,57014000,
331500,Bloomsburg University Of Pennsylvania,PA,7906785,12137403,21259000,41303188,0,
123900,Miracosta College,CA,5511006,12933970,22777000,41221976,0,
153600,University Of Miami,FL,8139089,11829536,21171000,41139625,0,
285800,State University Of New York At Farmingdale,NY,6154318,12645901,22339000,41139219,0,
686500,Camden County College,NJ,5784112,12826935,22495000,41106047,0,
840400,Brookdale Community College,NJ,6334411,12582654,22163000,41080065,0,
200600,Grambling State University,LA,7010388,12427854,21600000,41038242,0,
157100,Georgia Military College,GA,5998679,12723116,22285000,41006795,0,
189000,University Of Northern Iowa,IA,7618737,12078044,21259000,40955781,129019000,
275100,Long Island University,NY,7007826,12239114,21670000,40916940,238973000,
395500,University Of West Florida (The),FL,6801388,12369966,21717000,40888354,0,
151300,Pensacola State College,FL,6004939,12679127,22177000,40861066,0,
340700,Rhode Island College,RI,7443916,12110287,21159000,40713203,0,
964600,Piedmont Community College,NC,569586,1256023,38852000,40677609,33276000,
299700,North Dakota State University - Fargo,ND,7728326,11906777,21024000,40659103,0,
363900,Texas A&M University - Kingsville,TX,7087427,12173235,21281000,40541662,0,
321800,Chemeketa Community College,OR,5750738,12612572,22114000,40477310,0,
342800,College Of Charleston,SC,7642022,11866554,20905000,40413576,100136000,
135800,Colorado Mesa University,CO,7068379,12116155,21213000,40397534,34875000,
396100,Harper College,IL,5526516,12582067,22281000,40389583,25382000,
696100,Jefferson Community And Technical College,KY,5179693,12800342,22392000,40372035,0,
232600,University Of Michigan - Dearborn,MI,6989129,12130348,21231000,40350477,0,
245400,University Of Central Missouri,MO,6908319,12074346,21271000,40253665,0,
400700,Madison Area Technical College,WI,5500069,12510691,22095000,40105760,0,
690100,Rowan College Of South Jersey,NJ,6557641,12793980,20637000,39988621,0,
392000,University Of Wisconsin - Oshkosh,WI,6207761,11441915,22157000,39806676,0,
711000,Delaware County Community College,PA,5360154,12387247,22039000,39786401,0,
1039100,Oklahoma City Community College,OK,5566700,12328985,21760000,39655685,0,
251900,University Of Missouri - Saint Louis,MO,5830225,12190644,21566000,39586869,0,
169900,Joliet Junior College,IL,5497625,12291882,21773000,39562507,0,
367100,Dixie State University,UT,6176699,12124489,21246000,39547188,0,
162600,University Of Idaho,ID,6905295,11786287,20753000,39444582,291868000,
2288400,Gwinnett Technical College,GA,5336576,12417270,21682000,39435846,0,
156400,Emory University,GA,7974341,11277994,20158000,39410335,7872381000,
400300,Central Texas College District,TX,4544176,12611938,22185000,39341114,0,
150900,Nova Southeastern University,FL,7157194,11510184,20494000,39161378,0,
332200,Kutztown University Of Pennsylvania,PA,7424966,11533902,20190000,39148868,0,
722800,University Of Puerto Rico - Arecibo,PR,7684735,11195711,20153000,39033446,0,
200800,Louisiana Tech University,LA,7094887,11558542,20121000,38774429,0,
1088100,Stark State College,OH,5036299,12228524,21385000,38649823,0,
250100,Southeast Missouri State University,MO,6830214,11510345,20198000,38538559,0,
332700,Slippery Rock University,PA,7354069,11285058,19805000,38444127,0,
128500,Santa Barbara City College,CA,5767428,11790275,20856000,38413703,0,
846600,Southwestern Community College,NC,1187630,2482510,34712000,38382140,0,
238800,University Of Minnesota Duluth,MN,7453951,11174098,19706000,38334049,0,
376500,Norfolk State University,VA,6901715,11451132,19898000,38250847,24435000,
231400,Saginaw Valley State University,MI,6911064,11372114,19912000,38195178,87436000,
391700,University Of Wisconsin - Eau Claire,WI,7091955,11056971,19990000,38138926,81094000,
897600,Clayton State University,GA,6165671,11647843,20280000,38093514,0,
130500,Stanford University,CA,7376668,10890455,19630000,37897123,27699834000,1185700
824400,Johnson County Community College,KS,5080285,11797233,21010000,37887518,0,
232800,Washtenaw Community College,MI,4968890,11902486,20985000,37856376,0,
999400,Passaic County Community College,NJ,5451658,11803091,20591000,37845749,0,
165200,Harold Washington College,IL,5708949,11637196,20372000,37718145,0,
227800,Lansing Community College,MI,5804315,11559366,20306000,37669681,0,
1146200,University Of Alaska Anchorage,AK,5445184,11625475,20584000,37654659,0,
286600,Fashion Institute Of Technology,NY,7035399,11106697,19490000,37632096,0,
127300,San Diego City College,CA,4592301,11923790,21094000,37610091,0,
367400,Stevens Henager College,UT,2830028,11895706,22811000,37536734,0,
158100,Middle Georgia State University,GA,5988167,11474878,20012000,37475045,0,
467300,Baker College,MI,5754381,11529356,20091000,37374737,0,
367800,Southern Utah University,UT,5624696,11460963,20173000,37258659,0,
156100,Columbus State University,GA,6352178,11232074,19633000,37217252,69502000,
107800,Phoenix College,AZ,4772192,11740227,20595000,37107419,0,
154400,Albany State University,GA,5137088,11661954,20281000,37080042,0,
769400,College Of Lake County,IL,4973042,11539049,20458000,36970091,0,
226100,Charles Stewart Mott Community College,MI,5378749,11499149,20052000,36929898,0,
132500,University Of San Francisco,CA,7293888,10701243,18909000,36904131,399571000,
354100,Angelo State University,TX,6359561,11037672,19375000,36772233,0,
169300,Northeastern Illinois University,IL,6070904,11170485,19527000,36768389,0,
295400,University Of North Carolina At Pembroke,NC,6274710,11102045,19354000,36730755,24886000,
369600,University Of Vermont And State Agricultural College,VT,7055880,10675412,18995000,36726292,0,
576300,Central Georgia Technical College,GA,5100288,11496965,20061000,36658253,0,
197600,Morehead State University,KY,6016440,11119678,19479000,36615118,0,
185700,Southwestern Community College,IA,587388,1264937,34712000,36564325,0,
248000,Lindenwood University,MO,6706309,10755236,18921000,36382545,0,
399800,Chattanooga State Community College,TN,5283482,11325214,19762000,36370696,0,
284600,State University Of New York At New Paltz,NY,6537407,10821964,18954000,36313371,0,
110100,University Of Arkansas At Little Rock,AR,5956500,11008760,19287000,36252260,0,
206200,Bowie State University,MD,6596246,10788569,18806000,36190815,0,
376400,Virginia State University,VA,6855810,10694110,18639000,36188920,57383000,
306800,Lorain County Community College,OH,4917956,11339576,19872000,36129532,40485000,
3956300,South Louisiana Community College,LA,5645949,11077607,19326000,36049556,0,
218800,Salem State University,MA,6512818,10710632,18782000,36005450,49755000,
146700,Bethune Cookman University,FL,6648501,10731233,18601000,35980734,0,
202100,Northwestern State University,LA,5647034,11025862,19278000,35950896,0,
287500,Onondaga Community College,NY,5222555,11118319,19484000,35824874,0,
562000,Chattahoochee Technical College,GA,4903653,11215138,19677000,35795791,0,
393200,University Of Wyoming,WY,6613580,10546335,18627000,35786915,515121000,
282300,Saint John'S University,NY,12191880,20127659,3460000,35779539,208738000,
4248500,Texas A&M University-San Antonio,TX,5613425,10982357,19141000,35736782,0,
3156300,Estrella Mountain Community College,AZ,4856585,11191621,19610000,35658206,0,
242700,Northwest Mississippi Community College,MS,5787016,10861070,18998000,35646086,0,
153800,University Of Tampa (The),FL,6941444,10370376,18283000,35594820,0,
1269300,Pellissippi State Community College,TN,5171189,10977362,19281000,35429551,11604000,
3549300,Ultimate Medical Academy,FL,469150,12230799,22713000,35412949,0,
406200,Pitt Community College,NC,5510793,10858478,18997000,35366271,0,
391900,University Of Wisconsin - Lacrosse,WI,6789642,10311865,18212000,35313507,0,
524400,Bluegrass Community & Technical College,KY,4961119,11036893,19303000,35301012,0,
221000,University Of Massachusetts - Dartmouth,MA,6288232,10476776,18352000,35117008,0,
182700,Purdue University Northwest,IN,5824998,10594351,18589000,35008349,0,
317800,Seminole State College,OK,1163326,2326059,31497000,34986385,0,
531700,Forsyth Technical Community College,NC,4933805,9807067,20195000,34935872,0,
359000,Mclennan Community College,TX,4898030,10915188,19117000,34930218,0,
392400,University Of Wisconsin - Stevens Point,WI,6312792,9947577,18504000,34764369,0,
182800,Purdue University Fort Wayne,IN,5589305,10558946,18545000,34693251,0,
695100,University Of South Carolina Upstate,SC,6104655,10394456,18124000,34623111,0,
332000,East Stroudsburg University Of Pennsylvania,PA,6469323,10246794,17903000,34619117,0,
1054600,Century College,MN,4996271,10765178,18844000,34605449,0,
354000,Amarillo College,TX,4794394,10841767,18938000,34574161,0,
197700,Murray State University,KY,6270769,10236265,17965000,34472034,89480000,
225100,Delta College,MI,5146606,10658617,18631000,34436223,25581000,
711500,Moorpark College,CA,5143560,10545381,18699000,34387941,0,
150400,"State College Of Florida, Manatee-Sarasota",FL,5023266,10660667,18697000,34380933,0,
202000,University Of Louisiana At Monroe,LA,5777764,10393276,18208000,34379040,0,
102000,Jacksonville State University,AL,6050640,10296298,18020000,34366938,0,
298600,Winston-Salem State University,NC,6117980,10294709,17902000,34314689,49755000,
152100,Southeastern University,FL,4820567,8993865,20494000,34308432,0,
286800,Hudson Valley Community College,NY,5108581,10491761,18480000,34080342,0,
159000,Savannah State University,GA,6374932,10115570,17553000,34043502,0,
180800,University Of Southern Indiana,IN,5890282,10178801,17918000,33987083,0,
100500,Alabama State University,AL,6284463,10072950,17575000,33932413,0,
316100,Northeastern State University,OK,5676974,10255813,17916000,33848787,0,
165000,City Colleges Of Chicago - Malcolm X College,IL,4919757,10502178,18381000,33802935,0,
386300,Marquette University,WI,6646735,9752321,17303000,33702056,698021000,
347100,South Dakota State University,SD,6020168,9990468,17669000,33679636,132678000,
152600,Saint Leo University,FL,4579587,10573988,18512000,33665575,0,
1171100,University Of Houston - Clear Lake,TX,5555369,10205153,17892000,33652522,0,
795400,Normandale Community College,MN,4802575,10454594,18376000,33633169,0,
366500,West Texas A&M University,TX,5764767,10101563,17714000,33580330,0,
212800,Boston College,MA,6448576,9728036,17397000,33573612,2523300000,
217500,Quinsigamond Community College,MA,4828361,10469338,18267000,33564699,0,
142600,Yale University,CT,6851139,9389616,17320000,33560755,30314800000,1662000
4211800,College Of Western Idaho,ID,4030648,10671497,18852000,33554145,0,
157900,Augusta University,GA,6145342,9937667,17469000,33552009,0,
184300,Vincennes University,IN,4866528,10327711,18333000,33527239,0,
292000,Duke University,NC,6714022,9388487,17421000,33523509,8609004000,
165500,Wilbur Wright College,IL,5035279,10302824,18170000,33508103,0,
147100,College Of Central Florida,FL,5063707,10354340,18073000,33491047,72029000,
260700,Fairleigh Dickinson University,NJ,5771203,10026608,17685000,33482811,91625000,
231500,Schoolcraft College,MI,4676826,10389325,18273000,33339151,0,
130800,Reedley College,CA,4243892,10534587,18560000,33338479,0,
492500,Horry - Georgetown Technical College,SC,5158587,10253428,17878000,33290015,0,
166500,Columbia College Chicago,IL,6341542,9790759,17135000,33267301,0,
698200,Naugatuck Valley Community College,CT,3819528,8536320,20873000,33228848,0,
230100,Northern Michigan University,MI,5994618,9891128,17337000,33222746,15400000,
163600,Southwestern Illinois College,IL,4677515,10331215,18191000,33199730,0,
236200,Minneapolis Community And Technical College,MN,4640122,10358338,18086000,33084460,0,
814500,Nashville State Community College,TN,4689355,10323371,18051000,33063726,0,
356300,Del Mar College,TX,3854029,10600037,18596000,33050066,0,
2515400,City College,FL,1316096,2746762,28984000,33046858,0,
201500,University Of New Orleans (The),LA,5581887,9972376,17484000,33038263,0,
207700,Johns Hopkins University,MD,6266940,9496212,17260000,33023152,6275939000,
361100,South Plains College,TX,5182219,10118799,17691000,32992018,0,
143400,American University (The),DC,6314017,9543682,17070000,32927699,0,
962100,Herzing University,WI,4328833,10441249,18122000,32892082,0,
284300,Suny College At Cortland,NY,6245138,9642783,16892000,32779921,0,
817500,Howard Community College,MD,4800099,10064936,17703000,32568035,0,
553300,Saint Paul College - A Community & Technical College,MN,4580520,10171146,17756000,32507666,0,
252000,Washington University In St. Louis,MO,6368472,9322223,16806000,32496695,7953986000,
217600,Bristol Community College,MA,4686502,10097346,17629000,32412848,0,
121600,University Of La Verne,CA,5658977,9709997,17020000,32388974,111994000,
111000,University Of Arkansas At Fort Smith,AR,5511303,9777559,17053000,32341862,0,
144500,Georgetown University,DC,6110643,9301024,16800000,32211667,1822484000,
209100,Salisbury University,MD,5959457,9493680,16709000,32162137,56034000,
2100000,Universidad Politecnica De Puerto Rico,PR,5734996,9627350,16750000,32112346,0,
177300,Triton College,IL,4211898,10068612,17778000,32058510,0,
167500,Elgin Community College,IL,4600718,9931520,17497000,32029238,6973000,
532000,Cape Fear Community College,NC,4726439,9895172,17347000,31968611,0,
101300,Calhoun Community College,AL,4392248,10001547,17570000,31963795,0,
991200,Volunteer State Community College,TN,4689090,9915202,17352000,31956292,0,
954200,Community College Of Denver,CO,4443177,9998358,17497000,31938535,0,
1048700,West Georgia Technical College,GA,4442806,10007656,17473000,31923462,0,
710900,Suny College At Old Westbury,NY,5522673,9608491,16756000,31887164,0,
155900,Clark Atlanta University,GA,6064349,9435889,16384000,31884238,0,
120600,Golden West College,CA,4318142,9911380,17502000,31731522,0,
1116300,University Of Texas At Tyler,TX,5194610,9592692,16870000,31657302,0,
379300,Spokane Community College,WA,4173204,9935519,17521000,31629723,0,
177400,University Of Chicago (The),IL,6207010,8988981,16299000,31494991,0,
3072200,Chandler - Gilbert Community College,AZ,4350989,9757937,17329000,31437926,0,
393700,Universidad Del Sagrado Corazón,PR,5395359,9498506,16494000,31387865,0,
182200,Indiana Wesleyan University,IN,4543246,9731895,17082000,31357141,204472000,
891800,Saddleback College,CA,4296103,9691596,17348000,31335699,0,
273200,Hofstra University,NY,6249515,9026013,16022000,31297528,622235000,
794700,Beth Medrash Govoha Of America,NJ,5899593,9210836,16175000,31285429,0,
324200,Carnegie Mellon University,PA,5735086,9045100,16300000,31080186,2542650000,
205800,Anne Arundel Community College,MD,4315345,9667547,17083000,31065892,0,
2055400,Bossier Parish Community College,LA,3915911,9852065,17154000,30921976,0,
107100,Arizona Western College,AZ,4528738,9589819,16774000,30892557,0,
299200,University Of Mary,ND,1536188,2560792,26720000,30816980,55479000,
239600,Alcorn State University,MS,5886916,9094866,15791000,30772782,0,
445200,Montgomery County Community College,PA,4090103,9628984,16971000,30690087,0,
332500,Millersville University Of Pennsylvania,PA,5617301,9089274,15962000,30668575,0,
292800,Fayetteville State University,NC,5084687,9308810,16228000,30621497,24341000,
2539500,Irvine Valley College,CA,4485810,9394933,16692000,30572743,0,
375900,J Sargeant Reynolds Community College,VA,4151184,9595572,16821000,30567756,0,
284700,Suny College At Oneonta,NY,5740817,9003120,15766000,30509937,0,
300500,University Of North Dakota,ND,5491551,8980342,15956000,30427893,0,
263200,Seton Hall University,NJ,5749918,8857951,15734000,30341869,264514000,
694900,Kalamazoo Valley Community College,MI,4249299,9456126,16593000,30298425,17756000,
116200,Chabot College,CA,4156840,9409398,16689000,30255238,0,
201700,Mcneese State University,LA,5456361,8997322,15771000,30224683,0,
239400,Winona State University,MN,5696956,8890555,15629000,30216511,0,
289400,University Of Rochester,NY,6011698,8616921,15479000,30107619,2239720000,
720600,University Of Puerto Rico - Cayey University College,PR,5738057,8907729,15439000,30084786,0,
1212300,"University Of Puerto Rico, Aguadilla Regional College",PR,5899782,8844300,15334000,30078082,0,
120900,Hartnell Community College,CA,3615339,9501755,16836000,29953094,0,
2508300,Southeast Community College,NE,4282436,9303287,16347000,29932723,0,
106000,Coastal Alabama Community College,AL,4437762,9254055,16218000,29909817,0,
3079900,City College,FL,292345,572965,28984000,29849310,0,
4173500,Moreno Valley College,CA,3681844,9460917,16674000,29816761,0,
575300,Owens Community College,OH,3937786,9317892,16429000,29684678,0,
1245200,Evergreen Valley College,CA,3949985,9289992,16388000,29627977,0,
1034500,Cincinnati State Technical & Community College,OH,4228115,9223681,16172000,29623796,0,
363600,Texas Christian University,TX,5728641,8566705,15238000,29533346,1708867000,
262400,Ocean County College,NJ,4265169,9137920,16095000,29498089,0,
537800,Northeast State Community College,TN,4488316,8967575,15643000,29098891,12483000,
559900,Augusta Technical College,GA,4386678,8997908,15656000,29040586,0,
101600,University Of North Alabama,AL,5002648,8666299,15192000,28860947,0,
200500,Nicholls State University,LA,5057520,8626311,15095000,28778831,0,
357800,University Of The Incarnate Word,TX,5219687,8535960,15010000,28765647,142071000,
128900,Shasta College,CA,3673274,9115270,15977000,28765544,0,
142800,Delaware State University,DE,5565920,8459446,14739000,28764366,0,
332600,Shippensburg University Of Pennsylvania,PA,5436200,8476435,14850000,28762635,0,
1182000,San Diego Miramar College,CA,3235898,9144193,16296000,28676091,0,
353100,University Of Tennessee - Martin,TN,5110311,8551121,14953000,28614432,0,
530100,Northeast Wisconsin Technical College,WI,3736257,8993456,15845000,28574713,0,
395600,Dalton State College,GA,4768309,8679276,15116000,28563585,0,
359300,Navarro College,TX,4101645,8879685,15578000,28559330,0,
2075300,University Of Arkansas - Pulaski Technical College,AR,4476116,9423959,14656000,28556075,0,
111100,Allan Hancock College,CA,3853901,8924491,15766000,28544392,0,
345600,Winthrop University,SC,5382130,8423174,14737000,28542304,57949000,
965200,"University Of Puerto Rico, Ponce",PR,5314251,8364340,14856000,28534591,0,
353500,Vanderbilt University,TN,5632423,8200868,14679000,28512291,6270877000,
355800,North Central Texas College,TX,3862598,8921316,15708000,28491914,0,
831000,Auburn University Montgomery,AL,5075473,8523023,14878000,28476496,0,
202900,Tulane University,LA,5590189,8175012,14674000,28439201,1429707000,
284900,State University Of New York College At Plattsburgh,NY,5258169,8423237,14725000,28406406,0,
184000,University Of Notre Dame,IN,5793244,7969565,14590000,28352809,11268365000,1125650
192600,Pittsburg State University,KS,5318769,8353746,14657000,28329515,76528000,
250600,Saint Louis University,MO,5141085,8305153,14862000,28308238,1252678000,
681000,Lehigh Carbon Community College,PA,3873075,8853093,15507000,28233168,0,
284400,Suny At Fredonia,NY,5513590,8267340,14420000,28200930,0,
773000,Rowan College At Burlington County,NJ,3750316,8855454,15595000,28200770,0,
205400,University Of Southern Maine,ME,4616245,8534700,15016000,28166945,0,
266600,Adelphi University,NY,5246966,8279486,14638000,28164452,187211000,
687100,Thomas Nelson Community College,VA,3853969,8822513,15468000,28144482,0,
339500,Pennsylvania College Of Technology,PA,5341470,8301655,14480000,28123125,0,
286200,Suny Broome Community College,NY,4364871,8632801,15094000,28091672,0,
116400,Chapman University,CA,5505229,8137393,14448000,28090622,417705000,
378000,Green River College,WA,4763642,8421086,14866000,28050728,0,
158000,Mercer University,GA,5265925,8211054,14489000,27965979,0,
363800,Texas College,TX,2358852,3406198,22185000,27950050,0,
248800,Missouri Southern State University,MO,4756273,8447302,14728000,27931575,0,
102200,Jefferson State Community College,AL,3729878,8768415,15424000,27922293,0,
126600,Laney College,CA,3313469,8854083,15664000,27831552,0,
3064600,Texas Southmost College,TX,3608280,8774434,15365000,27747714,0,
319600,Lane Community College,OR,3014266,8943191,15732000,27689457,0,
2116300,Pueblo Community College,CO,3638453,8728074,15283000,27649527,0,
950700,Georgia Highlands College,GA,4220236,8527676,14892000,27639912,0,
251700,Missouri University Of Science And Technology,MO,5205598,8118979,14310000,27634577,0,
1034000,Los Medanos College,CA,3838971,8585259,15148000,27572230,0,
562100,Southern Crescent Technical College,GA,3912287,8586232,14946000,27444519,0,
259600,Atlantic Cape Community College,NJ,3960342,8555148,14917000,27432490,0,
243000,Pearl River Community College,MS,4385949,8368310,14586000,27340259,0,
301200,Ashland University,OH,3987716,8488692,14846000,27322408,0,
2066200,"New School, The",NY,4996686,7998165,14252000,27246851,0,
360800,Saint Philip'S College,TX,3427506,8602242,15215000,27244748,0,
146600,Barry University,FL,5027398,8001386,14127000,27155784,45448000,
391500,University Of Wisconsin - Stout,WI,4952605,8039386,14150000,27141991,0,
232700,University Of Michigan - Flint,MI,4600155,8146874,14284000,27031029,0,
325800,Duquesne University Of The Holy Spirit,PA,5373970,7783815,13873000,27030785,488351000,
474000,Mercer County Community College,NJ,3851115,8358417,14679000,26888532,0,
392100,University Of Wisconsin - Platteville,WI,4792670,7652424,14419000,26864094,0,
4176100,Norco College,CA,3523056,8421677,14892000,26836733,0,
240900,Itawamba Community College,MS,4419244,8115985,14154000,26689229,0,
2341300,Palo Alto College,TX,3240943,8485780,14933000,26659723,0,
312700,University Of Dayton,OH,5197738,7694898,13766000,26658636,604176000,
194900,Washburn University - Topeka,KS,4500174,8024016,14117000,26641190,0,
140200,Quinnipiac University,CT,5345199,7632879,13616000,26594078,556604000,
180400,University Of Indianapolis,IN,4902143,7840045,13754000,26496188,109448000,
249600,Northwest Missouri State University,MO,4792789,7854065,13791000,26437854,0,
787100,George C. Wallace State Community College,AL,4064802,8136032,14196000,26396834,0,
119200,Cuesta College,CA,3527579,8257338,14604000,26388917,35196000,
325900,Eastern University,PA,2228030,3602009,20494000,26324039,1055474000,
163400,Aurora University,IL,4697683,7853760,13760000,26311443,0,
227400,Jackson College,MI,3892134,8114820,14126000,26132954,0,
361400,Southwest Texas Junior College,TX,3736958,8149245,14243000,26129203,0,
675300,Illinois Central College,IL,3704633,8110353,14290000,26104986,0,
167400,Eastern Illinois University,IL,4506779,7820433,13746000,26073212,84387000,
400400,John Tyler Community College,VA,3448784,8170985,14407000,26026769,3785000,
492600,Tri-County Technical College,SC,4246483,7917841,13859000,26023324,27343000,
376900,Bellevue College,WA,4145089,7839658,14024000,26008747,0,
807800,Springfield Technical Community College,MA,3845054,8068676,14068000,25981730,0,
181600,Indiana University - South Bend,IN,4500518,7768280,13567000,25835798,0,
132900,University Of The Pacific,CA,5164869,7452559,13153000,25770428,463313000,
234500,University Of Saint Thomas,MN,5005202,7468750,13293000,25766952,0,
280300,Rensselaer Polytechnic Institute,NY,4828782,7283082,13563000,25674864,739648000,
854300,Atlanta Technical College,GA,3869156,7962803,13836000,25667959,0,
1028600,Suny Empire State College,NY,3411359,8060895,14170000,25642254,0,
240800,Holmes Community College,MS,3916962,7897652,13792000,25606614,0,
359200,Midwestern State University,TX,4413874,7678441,13427000,25519315,0,
3016000,University Of Puerto Rico Carolina Regional College,PR,4491903,7670211,13309000,25471114,0,
380500,Yakima Valley College,WA,4041726,7803497,13600000,25445223,0,
136500,Colorado State University-Pueblo,CO,3959862,7745423,13722000,25427285,0,
190600,Butler County Community College,KS,3631932,7901125,13881000,25414057,0,
221800,Suffolk University,MA,4935367,7382175,13033000,25350542,256300000,
264200,College Of New Jersey (The),NJ,5028131,7299736,12995000,25322867,0,
320400,Mount Hood Community College,OR,3385658,7917862,14019000,25322520,0,
261600,Monmouth University,NJ,4935299,7371976,12954000,25261275,107085000,
773100,Raritan Valley Community College,NJ,3819720,7748750,13657000,25225470,0,
451300,Housatonic Community College,CT,3450869,7936666,13806000,25193535,0,
2609400,Valley College,WV,328669,0,24804000,25132669,71832000,
2107700,Truckee Meadows Community College,NV,3347251,7834837,13868000,25050088,0,
3084400,Valley College,WV,230104,0,24804000,25034104,71832000,
217800,Massachusetts Institute Of Technology,MA,5045387,7130129,12812000,24987516,17569328000,1248400
803700,Gateway Community College,CT,4296723,9850045,10826000,24972768,0,
377400,Columbia Basin College,WA,3840410,7650276,13434000,24924686,0,
202500,Southern University And Agricultural & Mechanical Colg At Baton Rouge,LA,9396803,15459340,0,24856143,0,
134400,Yuba College,CA,3748918,7652045,13399000,24799963,0,
1164900,Loyola Marymount University,CA,4723135,7219025,12852000,24794160,0,
217700,Massasoit Community College,MA,3581373,7679157,13484000,24744530,0,
331600,California University Of Pennsylvania,PA,4312587,7410738,13000000,24723325,0,
233200,Anoka-Ramsey Community College,MN,3580976,7650597,13470000,24701573,0,
561500,Southern Regional Technical College,GA,3604073,7686039,13383000,24673112,0,
219000,Worcester State University,MA,4222833,7394799,13026000,24643632,0,
1284200,Oxnard College,CA,3127211,7788765,13663000,24578976,0,
101700,Gadsden State Community College,AL,3756166,7581323,13220000,24557489,0,
217000,Holyoke Community College,MA,3685390,7592856,13239000,24517246,0,
379600,Tacoma Community College,WA,3835874,7472853,13127000,24435727,0,
218900,Westfield State University,MA,4512060,7216874,12670000,24398934,0,
358000,Kilgore College,TX,3908886,7463341,12972000,24344227,0,
101800,George C. Wallace Community College,AL,3655757,7531363,13133000,24320120,0,
693100,Waubonsee Community College,IL,3198731,7586569,13494000,24279300,0,
285000,State University Of New York College At Potsdam,NY,4389510,7227985,12584000,24201495,0,
217300,North Shore Community College,MA,3446732,7520742,13151000,24118474,0,
886300,Walters State Community College,TN,3688117,7421588,12977000,24086705,0,
934400,Ramapo College Of New Jersey,NJ,4606705,7054659,12412000,24073364,21364000,
392300,University Of Wisconsin - River Falls,WI,4427466,7099284,12476000,24002750,0,
139700,University Of New Haven,CT,4642795,6999198,12336000,23977993,0,
139200,Manchester Community College,CT,3235201,7524805,13179000,23939006,0,
138000,Western Connecticut State University,CT,4256393,7148969,12533000,23938362,0,
229200,Michigan Technological University,MI,4605779,6991814,12339000,23936593,113645000,
195900,Campbellsville University,KY,3201468,7256937,13475000,23933405,0,
105900,Lawson State Community College,AL,3522022,7444227,12941000,23907249,0,
142200,University Of Hartford,CT,4467175,7020751,12399000,23886926,182812000,
142500,Eastern Connecticut State University,CT,4433725,7060353,12363000,23857078,0,
772900,County College Of Morris,NJ,3734038,7274185,12847000,23855223,0,
1255000,Los Angeles Mission College,CA,2940483,7612456,13292000,23844939,0,
538900,Gateway Technical College,WI,2614556,7675437,13535000,23824993,0,
216500,Mcphs University,MA,4414483,6808137,12549000,23771620,0,
320900,Western Oregon University,OR,4281683,7059841,12351000,23692524,0,
346300,Dakota State University,SD,771997,1819817,21024000,23615814,226626000,
393500,University Of Guam,GU,4564698,6947461,12103000,23615159,0,
286400,Dutchess Community College,NY,3592574,7233073,12767000,23592647,0,
285400,Suny College Of Technology At Alfred,NY,4425878,6987691,12158000,23571569,0,
125300,Fresno Pacific University,CA,4121557,7068175,12326000,23515732,0,
794800,Wilmington University,DE,3126974,7042779,13320000,23489753,0,
403300,Asheville Buncombe Technical Community College,NC,3686607,7164686,12605000,23456293,0,
221900,Tufts University,MA,4765237,6655929,12009000,23430166,1867962000,
278200,New York Institute Of Technology,NY,4377210,6855681,12109000,23341891,0,
711800,Parkland College,IL,3275003,7257218,12781000,23313221,0,
974400,Fox Valley Technical College,WI,2598816,7452169,13245000,23295985,0,
284500,Suny College At Geneseo,NY,4552123,6782413,11955000,23289536,0,
347900,Belmont University,TN,4597337,6711670,11957000,23266007,252091000,
180500,Indiana Institute Of Technology,IN,3336999,7249335,12632000,23218334,137039000,
342000,Benedict College,SC,4372336,6899448,11946000,23217784,0,
273900,Ithaca College,NY,4583253,6732724,11889000,23204977,347335000,
2111300,Cuyamaca College,CA,2918721,7329288,12907000,23155009,0,
502800,Inter American University Of Puerto Rico - Bayamon Campus,PR,8889905,14186459,0,23076364,0,
287400,Niagara County Community College,NY,3598909,7096692,12359000,23054601,0,
361300,Southern Methodist University,TX,4598259,6580843,11850000,23029102,1663864000,
328700,La Salle University,PA,4277300,6800498,11944000,23021798,80311000,
2177500,Rio Salado Community College,AZ,2531870,7331461,13123000,22986331,0,
2276900,Community College Of Aurora,CO,3035626,7224037,12720000,22979663,0,
402400,Georgia Northwestern Technical College,GA,3182360,7197142,12564000,22943502,0,
210800,Washington College,MD,1047397,1494341,20372000,22913738,236685000,
399400,Spartanburg Community College,SC,3358632,7124748,12428000,22911380,0,
218400,Fitchburg State University,MA,3910925,6854502,12103000,22868427,0,
3980300,California State University Channel Islands,CA,8580009,14288099,0,22868108,16050000,
156600,Fort Valley State University,GA,4166439,6827893,11853000,22847332,0,
108600,University Of Arkansas At Pine Bluff,AR,4295429,6774295,11748000,22817724,0,
287700,Rockland Community College,NY,3626632,6947584,12234000,22808216,0,
217400,Northern Essex Community College,MA,3271644,7115735,12415000,22802379,0,
1039500,University Of San Diego,CA,4426552,6592664,11746000,22765216,545552000,
679100,Suny College At Purchase,NY,4290517,6722248,11752000,22764765,0,
389900,University Of Wisconsin - Green Bay,WI,3504931,6769674,12470000,22744605,0,
302400,Case Western Reserve University,OH,4514183,6502716,11714000,22730899,1866500000,
1038800,Reading Area Community College,PA,3184345,7099987,12365000,22649332,0,
1118900,United Talmudical Seminary,NY,4482702,6631109,11501000,22614811,0,
3871300,Folsom Lake College,CA,2957869,7090043,12555000,22602912,0,
291300,Campbell University,NC,4307900,6604314,11634000,22546214,0,
140300,Sacred Heart University,CT,4305177,6550955,11652000,22508132,177133000,
377600,Everett Community College,WA,3327536,6893997,12254000,22475533,0,
146900,Florida Institute Of Technology,FL,3607645,6819739,12013000,22440384,87759000,
991400,Roane State Community College,TN,3314382,6955614,12163000,22432996,0,
4254200,Inter American University Of Puerto Rico San Germán Campus,PR,8830671,13593393,0,22424064,0,
199700,Somerset Community College,KY,3029445,7072505,12320000,22421950,0,
347400,University Of South Dakota,SD,3634766,6766389,11975000,22376155,244474000,
107400,Grand Canyon University,AZ,22351397,0,0,22351397,0,
144100,University Of The District Of Columbia,DC,3609526,6814702,11912000,22336228,0,
531800,Catawba Valley Community College,NC,2557958,5203663,14559000,22320621,0,
358300,Lee College,TX,4057094,8567819,9683000,22307913,363026000,
241100,Jones County Junior College,MS,3808681,6717113,11741000,22266794,0,
110700,Southern Arkansas University,AR,4025613,6634144,11587000,22246757,0,
918500,Rose State College,OK,3084740,6949136,12194000,22227876,0,
954300,Red Rocks Community College,CO,3149018,6889441,12160000,22198459,0,
3063300,Northwest Arkansas Community College,AR,3113618,6897894,12153000,22164512,0,
562400,Columbus Technical College,GA,3131902,6948954,12081000,22161856,0,
344600,South Carolina State University,SC,4062087,6611191,11484000,22157278,0,
277200,Mercy College,NY,7046720,12742981,2347000,22136701,255751000,
139900,Norwalk Community College,CT,3189661,6885402,12059000,22134063,0,
249000,Missouri Western State University,MO,3722351,6689868,11705000,22117219,0,
561800,Savannah Technical College,GA,3257084,6876107,11980000,22113191,0,
4253400,Clovis Community College,CA,2870984,6951508,12276000,22098492,0,
3802300,Uta Mesivta Of Kiryas Joel,NY,4265324,6530186,11301000,22096510,0,
1034300,College Of Micronesia-Fsm,FM,3640313,6749563,11684000,22073876,0,
237000,North Hennepin Community College,MN,3021425,6915297,12128000,22064722,0,
459800,Iowa Western Community College,IA,3175383,6848417,12013000,22036800,0,
989600,Oakton Community College,IL,2762839,6923930,12344000,22030769,5605000,
174700,Rock Valley College,IL,3290405,6777335,11948000,22015740,0,
3695700,Santiago Canyon College,CA,2893906,6866798,12250000,22010704,0,
681100,Luzerne County Community College,PA,3206325,6817714,11920000,21944039,0,
332100,Edinboro University Of Pennsylvania,PA,4181685,6446463,11298000,21926148,0,
362100,St. Edward'S University,TX,4142345,6472273,11309000,21923618,107026000,
176800,Saint Xavier University,IL,4057142,6501237,11335000,21893379,0,
287600,Orange County Community College,NY,3405395,6706076,11774000,21885471,0,
129200,Solano Community College,CA,3130214,6745292,11978000,21853506,0,
255100,University Of Nebraska - Kearney,NE,3925967,6501525,11417000,21844492,0,
1239300,Thomas Jefferson University,PA,4240183,6346019,11234000,21820202,0,
378700,Seattle Central College,WA,3252598,6694704,11851000,21798302,0,
530400,Chippewa Valley Technical College,WI,2765463,6860983,12110000,21736446,0,
485200,Clark State Community College,OH,2914627,6839500,11967000,21721127,0,
954400,Spokane Falls Community College,WA,3458313,6624036,11589000,21671349,0,
170700,Lewis University,IL,3978861,6397561,11269000,21645422,0,
348300,Columbia State Community College,TN,3285220,6664682,11688000,21637902,0,
338800,Villanova University,PA,4299419,6189181,11110000,21598600,766903000,
378100,Highline College,WA,3519738,6541137,11534000,21594875,0,
207200,Frostburg State University,MD,3925040,6416427,11238000,21579467,0,
1018200,Rogue Community College,OR,2523281,6927272,12117000,21567553,0,
164100,Bradley University,IL,4276013,6267487,11023000,21566500,320313000,
181700,Indiana University Southeast,IN,3667290,6482268,11350000,21499558,0,
112500,California Baptist University,CA,7913118,13577444,0,21490562,65618000,
315000,Cameron University,OK,3498279,6554643,11434000,21486922,0,
218500,Framingham State University,MA,3897751,6356373,11208000,21462124,0,
323900,Bucks County Community College,PA,3016924,6658039,11777000,21451963,0,
394000,Inter American University Of Puerto Rico - Metropolitan Campus,PR,7548666,13899227,0,21447893,0,
807300,Butte College,CA,7281962,14144568,0,21426530,0,
192500,Kansas City Kansas Community College,KS,2965092,6705791,11754000,21424883,0,
560000,Athens Technical College,GA,2983204,6704867,11704000,21392071,0,
2260600,Nuc University,PR,21367165,0,0,21367165,0,
262700,Princeton University,NJ,2424099,6776453,12166000,21366552,26116022000,730600
4130100,Louisiana Delta Community College,LA,2963756,6698731,11666000,21328487,0,
122400,Los Angeles Harbor College,CA,2906139,6734763,11668000,21308902,0,
2217100,Pima Medical Institute,AZ,21285691,0,0,21285691,0,
575400,Rowan-Cabarrus Community College,NC,2845506,6289645,12132000,21267151,0,
501500,University Of Wisconsin - Parkside,WI,3781946,6364119,11118000,21264065,0,
407500,Eastern Iowa Community College District,IA,2709712,6681568,11791000,21182280,0,
160200,Georgia College & State University,GA,4082028,6172402,10926000,21180430,0,
914500,Governors State University,IL,3702601,6348024,11096000,21146625,0,
164800,City Colleges Of Chicago Harry S Truman College,IL,3220360,6444909,11446000,21111269,0,
393900,Inter American University Of Puerto Rico - Aguadilla Campus,PR,8125496,12904606,0,21030102,0,
263800,Saint Peter'S University,NJ,3914585,6239918,10870000,21024503,0,
680400,Lakeland Community College,OH,3073894,6507072,11432000,21012966,0,
922600,Francis Marion University,SC,4141139,6135642,10699000,20975781,0,
152300,Saint Johns River State College,FL,2997937,6513669,11455000,20966606,0,
683600,Motlow State Community College,TN,3178784,6450317,11329000,20958101,0,
371400,Hampton University,VA,4264342,6056070,10617000,20937412,282543000,
206100,Baltimore City Community College,MD,2876155,6576135,11481000,20933290,0,
109800,Henderson State University,AR,3767931,5968320,11157000,20893251,0,
552500,Southern Maine Community College,ME,2897298,6511012,11429000,20837310,0,
186500,Iowa Central Community College,IA,3053198,6460442,11309000,20822640,0,
399000,Florence - Darlington Technical College,SC,3137478,6442168,11220000,20799646,0,
318800,Central Oregon Community College,OR,3183671,6331672,11127000,20642343,22459000,
531600,Coastal Carolina Community College,NC,3371351,6284036,10986000,20641387,0,
242600,Northeast Mississippi Community College,MS,3583689,6212227,10814000,20609916,0,
104000,Southern Union State Community College,AL,3196100,6311016,11066000,20573116,0,
321900,Southern Oregon University,OR,3422079,6202456,10913000,20537535,0,
376000,Virginia Western Community College,VA,2763297,6437437,11316000,20516734,0,
717000,Lincoln Land Community College,IL,2715449,6445621,11348000,20509070,0,
366800,Wharton County Junior College,TX,3060606,6308810,11135000,20504416,0,
866000,Germanna Community College,VA,2868710,6379347,11232000,20480057,0,
2165100,Edp University Of Puerto Rico,PR,3158114,6321077,10994000,20473191,0,
105000,Tuskegee University,AL,3756522,6066979,10633000,20456501,0,
154100,Abraham Baldwin Agricultural College,GA,3489407,6153343,10752000,20394750,0,
362700,Temple College,TX,2937041,6348038,11093000,20378079,0,
399200,Piedmont Technical College,SC,3433957,7392118,9522000,20348075,0,
2119100,Mission College,CA,1961952,5091885,13292000,20345837,0,
157500,Gordon State College,GA,3427492,6168119,10743000,20338611,0,
126800,Porterville College,CA,2896753,6326756,11032000,20255509,0,
486100,University Of Northwestern Ohio,OH,3906341,5948044,10382000,20236385,0,
377300,Clark College,WA,5205413,10339712,4680000,20225125,246794000,
784500,New England Institute Of Technology,RI,3676041,6026805,10495000,20197846,0,
302600,Central State University,OH,3645811,6020363,10498000,20164174,0,
569100,Shelton State Community College,AL,2965439,6242835,10927000,20135274,0,
173300,National Louis University,IL,3034098,6209964,10891000,20135062,36103000,
493700,Jackson State Community College,TN,2838469,6278510,10978000,20094979,0,
815500,Evergreen State College (The),WA,3787631,5880338,10261000,19928969,0,
384000,Western Technical College,WI,2379444,4982783,12564000,19926227,0,
553400,St. Cloud Technical And Community College,MN,3055197,6143474,10723000,19921671,0,
174900,Roosevelt University,IL,2927478,8905677,8047000,19880155,123353000,
252100,Webster University,MO,3517058,5874946,10478000,19870004,139792000,
199100,Elizabethtown Community And Technical College,KY,2426734,6335828,11106000,19868562,0,
240500,East Mississippi Community College,MS,3398901,5993735,10469000,19861636,0,
350000,Lee University,TN,3518557,5925628,10395000,19839185,1676308000,
502900,Inter American University Of Puerto Rico - Ponce Campus,PR,7526308,12302765,0,19829073,0,
265100,Eastern New Mexico University,NM,2914187,6119843,10775000,19809030,0,
370500,College Of William & Mary,VA,3948268,5677858,10171000,19797126,0,
3336300,Century College,PR,947701,0,18844000,19791701,0,
266000,San Juan College,NM,2737168,6182593,10848000,19767761,0,
164900,Richard J Daley College-City Colleges Of Chicago,IL,2993998,6024050,10705000,19723048,0,
830300,Gateway Community College,AZ,2707626,6158634,10826000,19692260,0,
381200,Fairmont State University,WV,3426559,5924797,10339000,19690356,0,
236700,Minnesota State University Moorhead,MN,3518533,5854257,10305000,19677790,0,
544800,Durham Technical Community College,NC,2803141,6117402,10738000,19658543,0,
379000,Seattle University,WA,3692919,5744310,10209000,19646229,0,
324000,Butler County Community College,PA,1882832,3855833,13881000,19619665,0,
119000,Contra Costa College,CA,2477887,6196600,10939000,19613487,0,
2623600,Paradise Valley Community College,AZ,2586404,6141870,10876000,19604274,0,
318100,Southwestern Oklahoma State University,OK,3443513,5864883,10278000,19586396,0,
342400,Claflin University,SC,3738216,5789854,10043000,19571070,0,
378400,Olympic College,WA,3129109,5935959,10501000,19566068,0,
191500,Fort Hays State University,KS,2524075,6157168,10826000,19507243,114719000,
3035700,Las Positas College,CA,2875491,5984875,10643000,19503366,0,
500100,Edmonds Community College,WA,2887689,5970004,10611000,19468693,0,
693800,Linn-Benton Community College,OR,2606675,6082320,10750000,19438995,0,
728300,Central Arizona College,AZ,3010509,5964675,10450000,19425184,0,
224900,Davenport University,MI,2925271,5986150,10488000,19399421,0,
103000,Bishop State Community College,AL,2871392,6026297,10500000,19397689,0,
764400,Lake Land College,IL,2510560,6026021,10796000,19332581,0,
399600,York Technical College,SC,3059291,5917462,10349000,19325753,0,
245600,Columbia College,MO,4385319,10707484,4172000,19264803,168869000,
314400,Xavier University,OH,3122063,4794656,11335000,19251719,199275000,
575200,Clover Park Technical College,WA,3266340,5802995,10181000,19250335,0,
859600,West Los Angeles College,CA,2215810,6229160,10784000,19228970,0,
1014900,Pepperdine University,CA,3620831,5540475,10054000,19215306,887461000,
197900,West Kentucky Community And Technical College,KY,2444514,6080214,10657000,19181728,0,
119900,Foothill College,CA,2401437,5970543,10790000,19161980,0,
358800,University Of Mary Hardin-Baylor,TX,3548693,5677713,9921000,19147406,0,
399500,Central Carolina Technical College,SC,2841256,5948759,10355000,19145015,0,
554100,Minnesota State Community And Technical College,MN,2832620,5922783,10388000,19143403,0,
108500,University Of Arkansas At Monticello,AR,3223313,5805440,10106000,19134753,0,
196200,University Of The Cumberlands,KY,2796798,5852797,10445000,19094595,0,
525600,Wiregrass Georgia Technical College,GA,2558893,6012298,10523000,19094191,0,
220500,Quincy College,MA,2770136,5711961,10529000,19011097,0,
366400,Weatherford College,TX,2547296,5967424,10494000,19008720,0,
262800,Rider University,NJ,3648210,5567041,9779000,18994251,66593000,
192700,Emporia State University,KS,3517620,5594046,9837000,18948666,79116000,
169100,Illinois Institute Of Technology,IL,3730000,5464457,9704000,18898457,236887000,
537200,South Puget Sound Community College,WA,2999739,5742134,10079000,18820873,0,
343500,Lander University,SC,3536994,5567453,9700000,18804447,0,
771300,Skyline College,CA,2491579,5852939,10457000,18801518,0,
502600,Inter American University Of Puerto Rico - Arecibo Campus,PR,7100104,11633980,0,18734084,0,
212600,Berklee College Of Music,MA,3573148,5472491,9683000,18728639,363026000,
164000,Prairie State College,IL,2523787,5872996,10316000,18712783,0,
107900,Yavapai College,AZ,2389592,5918433,10403000,18711025,0,
365400,University Of Saint Thomas,TX,1984472,3430711,13293000,18708183,0,
176900,South Suburban College Of Cook County,IL,2208424,5973385,10515000,18696809,0,
124200,Monterey Peninsula College,CA,2415633,5845034,10372000,18632667,0,
1252500,Caribbean University,PR,3713976,5445854,9468000,18627830,0,
994200,Shawnee State University,OH,3572909,5463226,9540000,18576135,19300000,
940100,Colorado Christian University,CO,2267714,5912413,10393000,18573127,0,
210600,University Of Maryland - Eastern Shore,MD,3542365,5476295,9553000,18571660,0,
141600,University Of Bridgeport,CT,3271938,5533358,9724000,18529296,0,
2505400,Atlantic University College,PR,3392323,5519097,9614000,18525420,0,
203200,Xavier University Of Louisiana,LA,3227606,5542343,9670000,18439949,0,
727500,Eastern Gateway Community College,OH,928466,6354688,11129000,18412154,0,
448100,Ohlone College,CA,2555988,5652458,10123000,18331446,0,
222500,Wentworth Institute Of Technology,MA,3469571,5314247,9539000,18322818,116142000,
290700,University Of North Carolina Asheville,NC,3359493,5428515,9499000,18287008,0,
758200,Aims Community College,CO,2541187,5693412,10034000,18268599,0,
666100,Angelina College,TX,2612956,5694082,9961000,18268038,0,
172800,Morton College,IL,2532643,5709962,10014000,18256605,0,
372400,Marymount University,VA,2074937,3297419,12852000,18224356,0,
362800,Texarkana College,TX,2568337,5694732,9946000,18209069,0,
195500,Berea College,KY,3516276,5326942,9337000,18180218,1218740000,
1049100,Hennepin Technical College,MN,2654457,5636807,9882000,18173264,0,
107200,Cochise College,AZ,3163235,5418622,9586000,18167857,0,
768600,Southern University At Shreveport - Bossier City,LA,2595115,5665245,9852000,18112360,0,
128200,San Jose City College,CA,2274964,5691504,10144000,18110468,0,
1099700,East Georgia State College,GA,2879553,5552828,9657000,18089381,0,
1097500,University Of Puerto Rico Bayamon Technical University College,PR,6991670,11082944,0,18074614,0,
153100,Stetson University,FL,3578583,5217973,9256000,18052556,255416000,
331800,Clarion University Of Pennsylvania,PA,3224275,5388310,9436000,18048585,0,
270500,College Of Saint Rose,NY,3475163,5285743,9263000,18023906,0,
248200,Maryville University Of Saint Louis,MO,3144097,5370742,9494000,18008839,0,
328900,Lehigh University,PA,3616135,5150737,9206000,17972872,1411641000,
298500,Wingate University,NC,3526458,5245491,9189000,17960949,0,
245900,Crowder College,MO,2638696,5563380,9748000,17950076,0,
132600,Santa Clara University,CA,3542678,5143956,9242000,17928634,1019760000,
4242100,University Of North Texas At Dallas,TX,3036810,5421911,9454000,17912721,0,
830400,Scottsdale Community College,AZ,2386925,5584623,9933000,17904548,0,
237300,Rochester Community And Technical College,MN,2629500,5542245,9711000,17882745,0,
118500,College Of The Redwoods,CA,2504489,5589825,9784000,17878314,0,
2530600,Saint Charles Community College,MO,2682474,5488788,9694000,17865262,0,
2244900,Goodwin University,CT,2365797,5191240,10288000,17845037,0,
2099500,Central Community College,NE,1890454,4636930,11309000,17836384,0,
102800,Miles College,AL,3257934,5320726,9211000,17789660,0,
276500,Marist College,NY,3344611,5195563,9219000,17759174,0,
206400,College Of Southern Maryland,MD,2579022,5480447,9683000,17742469,0,
241300,Meridian Community College,MS,2940110,5382355,9402000,17724465,0,
217200,Mount Wachusett Community College,MA,2554747,5520672,9634000,17709419,0,
562200,Georgia Piedmont Technical College,GA,2699452,5465270,9522000,17686722,0,
176700,Benedictine University,IL,3297892,5212121,9176000,17686013,0,
704700,Los Angeles Southwest College,CA,2222854,5686223,9755000,17664077,0,
221100,Springfield College,MA,3458881,5146652,9041000,17646533,77932000,
332300,Lock Haven University Of Pennsylvania,PA,3395845,5183846,9060000,17639691,0,
124300,Mount Saint Mary'S University,CA,3135747,5279211,9199000,17613958,0,
4114300,Nevada State College,NV,2755743,5390156,9445000,17590899,0,
161900,College Of Southern Idaho,ID,2076917,5569456,9878000,17524373,0,
573300,Bevill State Community College,AL,2642839,5413481,9466000,17522320,0,
249500,Truman State University,MO,3345344,5119742,9038000,17503086,0,
294900,University Of Mount Olive,NC,3337015,5154411,8990000,17481426,0,
132200,University Of Redlands,CA,3388020,5125485,8960000,17473505,182278000,
367900,Snow College,UT,2478311,5443723,9550000,17472034,0,
335700,Point Park University,PA,3193085,5185309,9085000,17463394,0,
976500,Three Rivers Community College,CT,2253229,5525543,9646000,17424772,0,
181500,Indiana University - Northwest,IN,2947212,5265615,9210000,17422827,0,
134600,Arapahoe Community College,CO,2079610,5512598,9808000,17400208,0,
335900,Robert Morris University,PA,3326878,5091859,8980000,17398737,37013000,
301400,Baldwin Wallace University,OH,3370528,5075637,8900000,17346165,179533000,
258200,Manchester Community College,NH,1203670,2953061,13179000,17335731,0,
339900,York College Of Pennsylvania,PA,3283784,5089255,8951000,17324039,0,
3112100,Dewey University,PR,3138599,5187169,8998000,17323768,0,
2305800,Florida Career College,FL,17303589,0,0,17303589,0,
249100,Moberly Area Community College,MO,2410386,5357897,9390000,17158283,0,
487800,Clackamas Community College,OR,1724926,5558561,9864000,17147487,0,
371900,Longwood University,VA,3220578,5039427,8881000,17141005,71363000,
257300,Dartmouth College,NH,3429350,4920074,8780000,17129424,5731322000,
344900,University Of South Carolina - Aiken,SC,3065412,5107433,8929000,17101845,0,
297300,Gaston College,NC,2520848,5286161,9276000,17083009,0,
233400,Augsburg University,MN,3259242,5018026,8777000,17054268,50786000,
315400,East Central University,OK,3066346,5075356,8875000,17016702,0,
155800,College Of Coastal Georgia,GA,2811985,5167644,9024000,17003629,0,
134800,Colorado School Of Mines,CO,3445115,4867096,8657000,16969211,289011000,
246800,Jefferson College,MO,2610155,5214046,9130000,16954201,134923000,
560100,Albany Technical College,GA,2451149,5281805,9185000,16917954,0,
161100,University Of Hawaii At Hilo,HI,2994725,5063323,8848000,16906048,0,
360400,Rice University,TX,3433160,4823060,8644000,16900220,6481102000,
120200,Gavilan College,CA,2328197,5265223,9285000,16878420,0,
678200,Genesee Community College,NY,2484880,5220960,9165000,16870840,0,
743700,Pittsburgh Technical College,PA,3296079,4947069,8599000,16842148,0,
993600,Middlesex Community College,MA,3704343,7847872,5242000,16794215,0,
242400,Mississippi Valley State University,MS,3079829,5002955,8694000,16776784,0,
1019800,Ecpi University,VA,16762368,0,0,16762368,0,
151000,Northwest Florida State College,FL,2530500,5151977,9069000,16751477,0,
240200,Copiah-Lincoln Community College,MS,3359493,4876965,8505000,16741458,0,
964700,Oklahoma State University - Oklahoma City,OK,2300829,5237822,9199000,16737651,0,
4111300,West Hills College Lemoore,CA,2260143,5260554,9204000,16724697,0,
769100,Mchenry County College,IL,2254053,5209015,9252000,16715068,0,
241600,Mississippi Delta Community College,MS,2743944,5097200,8873000,16714144,0,
291900,Davidson County Community College,NC,2636381,5117842,8944000,16698223,0,
277500,Molloy College,NY,2677888,5050913,8965000,16693801,40759000,
233600,Bemidji State University,MN,2813298,5037376,8841000,16691674,0,
808000,State Fair Community College,MO,2466914,5177384,9045000,16689298,0,
275800,Manhattan College,NY,3277749,4863451,8546000,16687200,107174000,
678500,Schenectady County Community College,NY,2266692,5230881,9173000,16670573,0,
759800,Hocking Technical College,OH,2402471,4437556,9826000,16666027,0,
315700,Langston University,OK,3082441,4959009,8623000,16664450,0,
207400,Hagerstown Community College,MD,2358314,5202597,9101000,16661911,0,
249800,Park University,MO,2805843,7132764,6712000,16650607,79527000,
185000,Central College,IA,928577,1416092,14290000,16634669,118586000,
329700,Mercyhurst University,PA,3142547,4900955,8574000,16617502,0,
297800,Wake Forest University,NC,3404708,4711472,8497000,16613180,1375398000,
676800,Mid Michigan College,MI,2641059,5077764,8873000,16591823,0,
254200,Creighton University,NE,3193341,4790999,8602000,16586340,587024000,
1017600,Westmoreland County Community College,PA,2377450,5157844,9051000,16586294,0,
546700,Sowela Technical Community College,LA,2493383,5120697,8938000,16552080,0,
360100,Paris Junior College,TX,2287333,5177107,9086000,16550440,0,
109700,Harding University,AR,3252861,4801524,8490000,16544385,151411000,
207500,Harford Community College,MD,2343664,5126050,9033000,16502714,0,
135300,Fort Lewis College,CO,3038637,4891889,8553000,16483526,0,
675600,Northshore Technical Community College,LA,2051300,5242703,9180000,16474003,0,
149000,Gulf Coast State College,FL,2415469,5086482,8929000,16430951,0,
865900,Lord Fairfax Community College,VA,2319604,5100496,9010000,16430100,0,
398500,Oral Roberts University,OK,2933238,4896140,8574000,16403378,0,
544900,Central Carolina Community College,NC,2422099,5053041,8873000,16348140,0,
316800,Rogers State University,OK,2586804,4985775,8699000,16271579,0,
273700,Iona College,NY,3070913,4776064,8388000,16234977,159938000,
379200,Skagit Valley College,WA,2333763,5028156,8855000,16216919,0,
232300,University Of Detroit Mercy,MI,3105323,4735579,8375000,16215902,69300000,
241500,Mississippi College,MS,3011426,4766371,8411000,16188797,0,
1146000,National University,CA,4563497,9227970,2335000,16126467,216382000,
192300,Hutchinson Community College,KS,2304535,5003358,8807000,16114893,0,
150200,Lake Sumter State College,FL,2306379,5012441,8790000,16108820,0,
362300,St. Mary'S University,TX,3180524,4682898,8205000,16068422,196463000,
763500,Capital Community College,CT,2032022,5110446,8912000,16054468,0,
285500,Suny College Of Technology At Canton,NY,2510929,4928910,8605000,16044839,0,
2306800,Platt College,OK,16031127,0,0,16031127,0,
976400,Tunxis Community College,CT,2185505,5023592,8790000,15999097,0,
500600,Walla Walla Community College,WA,2487718,4896390,8601000,15985108,0,
353700,Abilene Christian University,TX,2982741,4691178,8274000,15947919,451731000,
206800,Coppin State University,MD,2727906,4822740,8397000,15947646,0,
2146600,South Mountain Community College,AZ,2098614,5018347,8783000,15899961,0,
174100,Olivet Nazarene University,IL,2972237,4678981,8226000,15877218,0,
529400,Waukesha County Technical College,WI,1935258,5001888,8907000,15844146,0,
366300,Wayland Baptist University,TX,2509726,4830767,8477000,15817493,0,
263900,Stevens Institute Of Technology,NJ,3121706,4477648,8178000,15777354,224304000,
341900,Charleston Southern University,SC,2880272,4678162,8199000,15757434,0,
213300,Brandeis University,MA,3198465,4452458,8100000,15750923,1073526000,
354600,Coastal Bend College,TX,2133542,4928107,8661000,15722649,0,
546300,Alamance Community College,NC,2367785,4848030,8490000,15705815,0,
126200,Point Loma Nazarene University,CA,2913693,4628536,8162000,15704229,0,
1210500,National Park College,AR,2285507,4894868,8515000,15695375,0,
1002000,Lewis And Clark Community College,IL,2062380,4918298,8706000,15686678,0,
162300,North Idaho College,ID,2161877,4907648,8601000,15670525,0,
1036400,Whatcom Community College,WA,2392620,4813638,8456000,15662258,0,
340100,Brown University,RI,4842231,7008633,3794000,15644864,3976694000,
201600,Loyola University New Orleans,LA,2913258,4604038,8097000,15614296,0,
234200,St. Catherine University,MN,2645045,4698756,8253000,15596801,0,
184200,Valparaiso University,IN,3107360,4509425,7931000,15547785,259042000,
474300,Clovis Community College,NM,857725,2390522,12276000,15524247,0,
178800,Butler University,IN,3005303,4482000,7988000,15475303,0,
149900,Altierus Career College,FL,2524835,4730783,8205000,15460618,0,
244700,William Carey University,MS,2370656,4715985,8366000,15452641,0,
454900,Leeward Community College,HI,2067889,4835134,8543000,15446023,0,
730400,Culinary Institute Of America,NY,2997253,4507864,7909000,15414117,138298000,
353900,Alvin Community College,TX,2277498,4736789,8388000,15402287,0,
379100,Shoreline Community College,WA,2438333,4668215,8266000,15372548,0,
165400,City Colleges Of Chicago - Kennedy King College,IL,2144024,4811192,8414000,15369216,0,
227600,Kellogg Community College,MI,1991422,4855538,8521000,15367960,0,
229700,Muskegon Community College,MI,2247350,4751064,8332000,15330414,0,
382200,Shepherd University,WV,2679616,4591465,8052000,15323081,22145000,
106300,University Of Alaska Fairbanks,AK,2066651,4781679,8471000,15319330,0,
158200,Morehouse College,GA,2947819,4484089,7809000,15240908,0,
246100,Drury University,MO,2470201,4648448,8120000,15238649,96517000,
107300,Eastern Arizona College,AZ,2222272,4692651,8320000,15234923,0,
331300,Widener University,PA,2794641,4469255,7949000,15212896,94454000,
374600,University Of Mary Washington,VA,2888681,4448919,7856000,15193600,55479000,
133400,Ventura College,CA,4581538,10430052,173000,15184590,0,
357200,Trinity Valley Community College,TX,1865240,4808492,8454000,15127732,0,
3083800,Heartland Community College,IL,2092953,4701213,8324000,15118166,0,
259000,Keene State College,NH,2997360,4391814,7719000,15108174,0,
292700,Elon University,NC,2989232,4333388,7770000,15092620,273429000,
163800,Black Hawk College,IL,2172992,4663525,8230000,15066517,0,
287000,Jefferson Community College,NY,2361051,4618540,8068000,15047591,0,
159200,South Georgia State College,GA,2422737,4591608,7997000,15011345,0,
525400,Lanier Technical College,GA,2122657,4680489,8201000,15004146,0,
259700,Bloomfield College,NJ,2851037,4441931,7705000,14997968,0,
286900,Jamestown Community College,NY,2306997,4608853,8082000,14997850,0,
2559300,United Education Institute,CA,14992982,0,0,14992982,0,
359600,Odessa College,TX,2118029,4719893,8126000,14963922,0,
822100,Universal Technical Institute,AZ,14950305,0,0,14950305,0,
471300,Three Rivers College,MO,2281288,4609172,8030000,14920460,0,
394300,University Of Puerto Rico - Humacao University College,PR,5664236,9236475,0,14900711,0,
338400,University Of Scranton,PA,2938777,4297505,7645000,14881282,209760000,
378500,Pacific Lutheran University,WA,2935869,4339965,7604000,14879834,0,
189300,Upper Iowa University,IA,2210375,4587064,8048000,14845439,0,
118100,College Of San Mateo,CA,2042860,4571602,8217000,14831462,0,
240400,East Central Community College,MS,2606310,4456077,7763000,14825387,0,
378800,Seattle Pacific University,WA,2890475,4324878,7602000,14817353,124901000,
285700,Suny College Of Technology At Delhi,NY,2436849,4511025,7867000,14814874,0,
350200,Lincoln Memorial University,TN,2657937,4377528,7741000,14776465,0,
240100,Coahoma Community College,MS,3136873,4236381,7353000,14726254,0,
561900,North Georgia Technical College,GA,2114032,4588972,7992000,14695004,0,
357600,Houston Baptist University,TX,2615603,4386077,7689000,14690680,0,
807600,John A. Logan College,IL,1452644,4729234,8501000,14682878,0,
246600,Harris - Stowe State University,MO,2513580,4447990,7712000,14673570,0,
459500,Hawkeye Community College,IA,1769048,4673024,8230000,14672072,0,
380400,Whitworth University,WA,2840748,4295420,7526000,14662168,156048000,
133800,West Valley College,CA,2016079,4531612,8107000,14654691,0,
731600,Western Iowa Tech Community College,IA,2023618,4573145,8036000,14632763,0,
202600,Southern University At New Orleans,LA,2481663,4428953,7714000,14624616,0,
696000,Maysville Community And Technical College,KY,1992396,4591401,8018000,14601797,0,
1186400,Mohave Community College,AZ,1933935,4605866,8050000,14589801,0,
384200,Concordia University,WI,3667367,6084278,4831000,14582645,88859000,
204300,Husson University,ME,2674616,4321707,7574000,14570323,0,
181400,Indiana University - Kokomo,IN,2505620,4384864,7668000,14558484,0,
282000,Saint Francis College,NY,2673260,4322861,7549000,14545121,0,
279800,Pratt Institute,NY,2831205,4188674,7518000,14537879,215667000,
109100,Arkansas State University - Beebe,AR,2141764,4498666,7872000,14512430,0,
161300,Kapiolani Community College,HI,2022941,4484284,7954000,14461225,0,
293600,Johnson C Smith University,NC,2718468,4307958,7432000,14458426,0,
569700,Northwest - Shoals Community College,AL,2069470,4505213,7879000,14453683,0,
336700,Saint Joseph'S University,PA,2796324,4168820,7447000,14412144,294287000,
357000,Grayson College,TX,2157844,4451723,7796000,14405567,0,
111700,Azusa Pacific University,CA,5548456,8848314,0,14396770,0,
1216500,Atlanta Metropolitan State College,GA,2149954,4464596,7767000,14381550,0,
159400,Spelman College,GA,2804294,4189279,7384000,14377573,390462000,
380100,Wenatchee Valley College,WA,2466867,4320320,7585000,14372187,0,
256600,Wayne State College,NE,2521559,4301037,7547000,14369596,0,
326600,Gannon University,PA,2684679,4223568,7455000,14363247,65364000,
370600,Christopher Newport University,VA,2893936,4128127,7326000,14348063,0,
100300,Faulkner University,AL,2422978,4333744,7569000,14325722,15240000,
240300,Delta State University,MS,2524437,4272713,7524000,14321150,0,
377800,Gonzaga University,WA,2772507,4090622,7394000,14257129,294720000,
197200,Lindsey Wilson College,KY,2587859,4250842,7417000,14255701,0,
136300,Regis University,CO,2448686,4210720,7494000,14153406,69773000,
316200,Northern Oklahoma College,OK,1971017,4421809,7755000,14147826,0,
152200,South Florida State College,FL,2111445,4384283,7646000,14141728,0,
3115000,Arizona College,AZ,3665308,0,10450000,14115308,0,
199600,Big Sandy Community And Technical College,KY,1809773,4476232,7816000,14102005,0,
789300,Flagler College,FL,2708794,4137808,7247000,14093602,69919000,
4281700,Compton College,CA,2538405,0,11554000,14092405,0,
1116700,Community College Of Vermont,VT,1480650,4566679,8031000,14078329,0,
169400,Chicago State University,IL,2172014,4327173,7555000,14054187,0,
210200,University Of Baltimore,MD,2325946,4240961,7476000,14042907,49878000,
274800,Le Moyne College,NY,2709704,4105843,7215000,14030547,0,
124700,Napa Valley College,CA,2125082,4281704,7585000,13991786,0,
212000,Merrimack College,MA,2646845,4085510,7245000,13977355,0,
189100,University Of Dubuque,IA,2637393,4067317,7267000,13971710,160530000,
349900,Lane College,TN,2430978,4224957,7306000,13961935,0,
223300,Worcester Polytechnic Institute,MA,2707195,4013416,7195000,13915611,528287000,
539000,Blackhawk Technical College,WI,2201888,4269703,7428000,13899591,0,
278800,Niagara University,NY,2711396,4034215,7103000,13848611,97242000,
992800,Piedmont Virginia Community College,VA,1892438,4324347,7628000,13844785,0,
378600,Peninsula College,WA,1160439,2285928,10372000,13818367,0,
3034500,Owensboro Community & Technical College,KY,1789723,4372164,7652000,13813887,0,
1323100,University Of Houston - Victoria,TX,2233006,4184394,7374000,13791400,0,
102400,University Of West Alabama,AL,2384585,4135471,7266000,13786056,0,
551100,Coastal Pines Technical College,GA,1758137,4368692,7653000,13779829,0,
282100,Saint John Fisher College,NY,2681804,3994698,7039000,13715502,0,
253000,Montana State University - Billings,MT,2193195,4180539,7339000,13712734,0,
288300,Utica College,NY,2388832,4099539,7224000,13712371,24796000,
933600,Johnston Community College,NC,2258380,4152736,7290000,13701116,0,
201200,Louisiana State University At Eunice,LA,2060199,4236259,7391000,13687458,0,
151500,Rollins College,FL,2692112,3898553,7085000,13675665,379841000,
100400,University Of Montevallo,AL,2560001,4041651,7060000,13661652,0,
348600,Lipscomb University,TN,2582024,3982698,7074000,13638722,84430000,
341000,Roger Williams University,RI,2629911,3959064,7041000,13629975,86049000,
214600,Emerson College,MA,2734314,3921763,6964000,13620077,0,
840300,Indian Hills Community College,IA,2199657,4137403,7264000,13601060,0,
318500,University Of Tulsa (The),OK,2645588,3954569,7000000,13600157,0,
291600,Chowan University,NC,2614325,4018655,6964000,13596980,0,
243600,Southwest Mississippi Community College,MS,2320170,4117342,7158000,13595512,0,
317900,Southeastern Oklahoma State University,OK,2118149,4153547,7287000,13558696,0,
4263600,Northeast Lakeview College,TX,1343444,4407215,7799000,13549659,0,
296100,Sandhills Community College,NC,2033057,4181526,7335000,13549583,0,
210700,Stevenson University,MD,2499743,4005614,7033000,13538357,0,
678800,Tompkins Cortland Community College,NY,1845177,4215523,7470000,13530700,0,
681500,Orangeburg - Calhoun Technical College,SC,1996646,4204932,7325000,13526578,0,
383900,Carthage College,WI,2668496,3851906,6990000,13510402,111496000,
222600,Western New England University,MA,2684604,3915648,6902000,13502252,56683000,
527300,Gateway Community And Technical College,KY,1797783,4249192,7444000,13490975,0,
927200,Crafton Hills College,CA,1933930,4149254,7390000,13473184,0,
212400,Bentley University,MA,2665628,3883553,6918000,13467181,0,
208600,Mount Saint Mary'S University,MD,1678019,2584181,9199000,13461200,0,
235400,Hamline University,MN,2570227,3943823,6945000,13459050,100550000,
250200,Southwest Baptist University,MO,2301587,4056193,7100000,13457780,0,
230200,Northwestern Michigan College,MI,2124216,4118115,7197000,13439331,0,
2332800,Center For Employment Training,CA,2223425,4089677,7122000,13435102,0,
319400,George Fox University,OR,2589776,3921838,6923000,13434614,0,
281600,Siena College,NY,2620637,3899632,6853000,13373269,0,
207100,Frederick Community College,MD,1851890,4147691,7351000,13350581,0,
2073900,Wor-Wic Community College,MD,1860894,4183209,7303000,13347103,0,
340600,Providence College,RI,2699566,3830403,6812000,13341969,234228000,
793800,Lincoln College Of Technology,IN,13341054,0,0,13341054,0,
269900,Clarkson University,NY,2590707,3872273,6845000,13307980,201698000,
322400,University Of Portland,OR,2672004,3830681,6796000,13298685,0,
250000,College Of The Ozarks,MO,2518807,3934298,6838000,13291105,476624000,
321100,Oregon Institute Of Technology,OR,1807273,4145176,7337000,13289449,0,
126700,Merritt College,CA,1497283,4233724,7541000,13272007,0,
322900,Albright College,PA,2569568,3863482,6801000,13234050,77103000,
224100,Calvin University,MI,2639029,3829529,6764000,13232558,176538000,
207800,Loyola University Maryland,MD,2612460,3800541,6789000,13202001,232473000,
884900,Palm Beach Atlantic University,FL,2363047,3920083,6904000,13187130,85236000,
294200,Livingstone College,NC,2503063,3910216,6771000,13184279,0,
575700,Lake Superior College,MN,1757151,4132002,7292000,13181153,0,
339400,Wilkes University,PA,2403446,3896453,6879000,13178899,54044000,
293300,High Point University,NC,2605940,3731389,6826000,13163329,64777000,
399900,Cleveland State Community College,TN,1970716,4067122,7121000,13158838,0,
498800,Central Virginia Community College,VA,1817818,4111607,7215000,13144425,0,
553700,South Central College,MN,1873482,4096933,7173000,13143415,0,
200400,Dillard University,LA,2442809,3903275,6762000,13108084,0,
103100,Northeast Alabama Community College,AL,1901781,4075756,7117000,13094537,0,
527600,Central Maine Community College,ME,1882719,4059822,7081000,13023541,0,
239700,Belhaven University,MS,2204818,3919675,6880000,13004493,0,
351800,Southern Adventist University,TN,2443809,3826927,6704000,12974736,46402000,
287100,Mohawk Valley Community College - Suny Office Of Community Colleges,NY,4368811,8603935,0,12972746,0,
130200,Saint Mary'S College Of California,CA,2525736,3766129,6662000,12953865,181313000,
245300,Central Methodist University,MO,1766287,3984117,7192000,12942404,0,
112400,Cabrillo College,CA,4027260,8885242,0,12912502,0,
458700,Northeast Iowa Community College,IA,1835580,4009002,7056000,12900582,0,
993000,University Of Texas Of The Permian Basin,TX,1840016,4007546,7050000,12897562,0,
173500,North Park University,IL,2332872,3834812,6712000,12879684,79527000,
290300,Yeshiva University,NY,2479795,3711922,6680000,12871717,665001000,
201100,Louisiana State University At Alexandria,LA,1998555,3959812,6911000,12869367,0,
323500,Arcadia University,PA,2563133,3728760,6577000,12868893,82645000,
342300,"Citadel, The Military College Of South Carolina",SC,2499158,3698438,6663000,12860596,0,
199000,Ashland Community And Technical College,KY,1897125,3997808,6961000,12855933,0,
3091300,Regent University,VA,1567327,4071730,7153000,12792057,0,
302300,Capital University,OH,2486868,3710353,6534000,12731221,106663000,
1104600,Central Ohio Technical College,OH,1667250,4014980,7042000,12724230,0,
130900,Taft College,CA,1122910,4175867,7421000,12719777,0,
561700,South Georgia Technical College,GA,1870108,3954455,6883000,12707563,0,
231000,St. Clair County Community College,MI,1909478,3923106,6873000,12705584,0,
328300,Lackawanna College,PA,1885348,3937122,6882000,12704470,0,
295100,North Carolina Wesleyan College,NC,2177353,3837299,6674000,12688652,0,
217100,Massachusetts Bay Community College,MA,1775751,3944066,6968000,12687817,0,
709600,College Of The Mainland,TX,1767883,3950300,6957000,12675183,0,
979700,Midland College,TX,1673002,3920402,7073000,12666404,0,
162100,Lewis-Clark State College,ID,1979771,3877118,6799000,12655889,0,
173400,North Central College,IL,2410282,3713512,6517000,12640794,118586000,
970400,North Seattle College,WA,1795310,3896932,6946000,12638242,0,
149500,Jacksonville University,FL,2208846,3764301,6641000,12614147,46743000,
525200,Ridgewater College,MN,1950916,3860185,6761000,12572101,95758000,
538700,Northcentral Technical College,WI,1482377,3991652,7055000,12529029,0,
242200,Mississippi University For Women,MS,2188061,3763183,6566000,12517244,0,
355300,Cisco College,TX,1817547,3864761,6771000,12453308,0,
356000,Dallas Baptist University,TX,2198677,3689859,6525000,12413536,0,
573400,H. Councill Trenholm State Community College,AL,1892834,3837980,6679000,12409814,0,
546400,Richmond Community College,NC,1993968,3796431,6618000,12408399,0,
195400,Bellarmine University,KY,2469277,3570531,6298000,12337808,66331000,
186000,Drake University,IA,2224225,3636645,6470000,12330870,226155000,
160600,Brigham Young University - Hawaii,HI,2306881,3626535,6397000,12330416,0,
261000,Felician University,NJ,2243499,3667867,6395000,12306366,0,
282500,Saint Joseph'S College,NY,3745728,6203959,2315000,12264687,0,
277700,Medaille College,NY,2028538,3721180,6510000,12259718,0,
2166100,Elaine P. Nunez Community College,LA,1561099,3892436,6782000,12235535,0,
302500,Cedarville University,OH,2294323,3591516,6346000,12231839,36485000,
248600,Mineral Area College,MO,1986137,3722656,6504000,12212793,0,
201300,Louisiana State University In Shreveport,LA,1825886,3754151,6628000,12208037,0,
374400,University Of Richmond,VA,2425545,3524203,6256000,12205748,2517969000,
292600,Elizabeth City State University,NC,2130978,3679189,6391000,12201167,0,
970600,South Seattle College,WA,1861609,3692544,6629000,12183153,0,
199800,Southeast Kentucky Community And Technical College,KY,1616993,3839470,6717000,12173463,0,
298000,Wayne Community College,NC,1871243,3744411,6553000,12168654,0,
1193000,Roxbury Community College,MA,1677144,3819450,6649000,12145594,0,
148800,Florida Southern College,FL,2291992,3566789,6280000,12138781,79136000,
3022400,College Of The Marshall Islands,MH,1956673,3719492,6438000,12114165,0,
2120700,San Joaquin Valley College,CA,12104128,0,0,12104128,0,
270300,College Of Mount Saint Vincent,NY,2592348,3459827,6034000,12086175,0,
382300,West Liberty University,WV,2246663,3578510,6260000,12085173,0,
1166700,Northeast Community College,NE,1729207,3746465,6605000,12080672,0,
450600,Colorado Mountain College,CO,1694667,3735220,6647000,12076887,0,
294600,Methodist University,NC,1925342,2957602,7192000,12074944,1663864000,
258100,Nhti - Concord'S Community College,NH,1806576,3714959,6544000,12065535,0,
121500,La Sierra University,CA,2144179,3606411,6301000,12051590,0,
974000,Inver Hills Community College,MN,1718868,3737337,6585000,12041205,0,
4143800,Woodland Community College,CA,1623074,3766737,6640000,12029811,0,
1005600,Aiken Technical College,SC,1824100,3718101,6480000,12022201,0,
483500,Caldwell Community College & Technical Institute,NC,1753469,3728354,6538000,12019823,0,
172400,Millikin University,IL,2299043,3534156,6172000,12005199,106893000,
3627300,Lamar Institute Of Technology,TX,1836301,3711898,6453000,12001199,0,
378200,Lower Columbia College,WA,1810047,3702313,6473000,11985360,0,
266500,Vaughn College Of Aeronautics And Technology,NY,2140817,3593590,6248000,11982407,24465000,
296200,Shaw University,NC,2258545,3540428,6140000,11938973,0,
304500,University Of Findlay (The),OH,2250867,3488769,6194000,11933636,0,
143700,Catholic University Of America (The),DC,2374572,3406832,6148000,11929404,0,
383800,Carroll University,WI,2437429,3503766,5976000,11917195,223539000,
268100,Canisius College,NY,2334830,3470452,6108000,11913282,129201000,
348100,Carson - Newman University,TN,2295168,3490978,6121000,11907146,0,
234300,College Of Saint Scholastica,MN,2274924,3476779,6137000,11888703,0,
1250000,Ranken Technical College,MO,2185927,3523730,6137000,11846657,0,
499900,Bellingham Technical College,WA,1833051,3642353,6361000,11836404,0,
317600,Carl Albert State College,OK,1880688,3626361,6309000,11816049,0,
138500,Fairfield University,CT,2137358,3463328,6206000,11806686,374896000,
103600,Samford University,AL,2381353,3353321,6072000,11806674,0,
3698300,West Coast University,CA,11797821,0,0,11797821,0,
237500,Southwest Minnesota State University,MN,1644234,3629923,6487000,11761157,0,
315300,Connors State College,OK,1785542,3639242,6336000,11760784,0,
216000,Lesley University,MA,1997859,3513514,6244000,11755373,187972000,
522300,New River Community College,VA,1658163,3654725,6439000,11751888,0,
3789400,River Parishes Community College,LA,963683,3913055,6859000,11735738,0,
1167800,State University Of New York Polytechnic Institute,NY,2129510,3490152,6116000,11735662,0,
366200,Victoria College,TX,1680905,3650333,6396000,11727238,0,
376600,Virginia Union University,VA,2251677,3451922,6021000,11724599,0,
974300,Bellevue University,NE,1169139,3824467,6710000,11703606,0,
866100,Southside Virginia Community College,VA,1677846,3641711,6382000,11701557,0,
501900,Universidad Adventista De Las Antillas,PR,2178276,3474235,6026000,11678511,0,
1043400,Renton Technical College,WA,1717551,3599677,6356000,11673228,0,
368800,Northern Vermont University,VT,1932341,3530182,6161000,11623523,0,
726000,Southwest Virginia Community College,VA,1671535,3623306,6309000,11603841,0,
369200,Norwich University,VT,2004614,3477779,6121000,11603393,0,
386800,Milwaukee School Of Engineering,WI,2285262,3379921,5936000,11601183,0,
1006000,Vernon College,TX,1381106,3712194,6489000,11582300,0,
305000,John Carroll University,OH,2224405,3380237,5976000,11580642,223539000,
362500,Sul Ross State University,TX,1779991,3571688,6224000,11575679,0,
316000,Northeastern Oklahoma A & M College,OK,1934724,3512456,6119000,11566180,0,
685800,Unity College,ME,822158,1266150,9466000,11554308,77308000,
104600,Talladega College,AL,2069544,3454443,5987000,11510987,0,
359800,Our Lady Of The Lake University,TX,2078279,3418669,5998000,11494948,0,
1056700,Colegio Universitario De San Juan,PR,2002902,3471401,6012000,11486303,0,
375800,Danville Community College,VA,1604222,3591706,6289000,11484928,0,
311000,Otterbein University,OH,2255286,3344331,5879000,11478617,101386000,
345000,University Of South Carolina - Beaufort,SC,2075254,3423472,5972000,11470726,0,
204000,University Of Maine - Farmington,ME,2158052,3371441,5885000,11414493,0,
479900,Monroe College,NY,11408077,0,0,11408077,0,
869400,Rasmussen College,MN,11388948,0,0,11388948,0,
2572000,Vista College,TX,11351349,,,11351349,0,
233900,Central Lakes College,MN,1658191,3507873,6185000,11351064,0,
142400,Wesleyan University,CT,2257086,3252068,5837000,11346154,1004806000,
110300,Philander Smith College,AR,2143674,3363217,5820000,11326891,0,
214800,Endicott College,MA,2063007,3324451,5921000,11308458,95673000,
344100,North Greenville University,SC,2143104,3311855,5806000,11260959,0,
148600,Florida Memorial University,FL,2154643,3325368,5770000,11250011,0,
327500,Holy Family University,PA,2023957,3344930,5881000,11249887,0,
559600,Emily Griffith Technical College,CO,1828725,3372652,6045000,11246377,0,
303000,Ohio Christian University,OH,1748170,3453072,6022000,11223242,0,
886200,East Central College,MO,1651321,3471107,6066000,11188428,0,
175300,School Of The Art Institute Of Chicago,IL,2167774,3250859,5763000,11181633,0,
308900,Ohio Northern University,OH,2189709,3255742,5733000,11178451,160300000,
193700,Ottawa University,KS,1667633,3455105,6044000,11166738,0,
308300,University Of Mount Union,OH,2209587,3235680,5714000,11159267,140318000,
117800,College Of Marin,CA,1347945,3526729,6281000,11155674,0,
175000,Dominican University,IL,3025781,4672507,3457000,11155288,40445000,
199400,Hopkinsville Community College,KY,1399325,3556627,6197000,11152952,0,
129300,Vanguard University Of Southern California,CA,1879831,3373721,5899000,11152552,0,
3030000,Ogeechee Technical College,GA,1622353,3469544,6046000,11137897,0,
769000,Kankakee Community College,IL,1267153,3574930,6278000,11120083,0,
381000,Concord University,WV,2057014,3299115,5763000,11119129,0,
183900,Trine University,IN,1800977,3358765,5958000,11117742,0,
266800,Alfred University,NY,2093987,3260034,5739000,11093021,138254000,
357400,Howard County Junior College District,TX,1454607,3485538,6129000,11069145,0,
336900,Susquehanna University,PA,2191211,3214295,5663000,11068506,173197000,
727900,Hawaii Pacific University,HI,1879700,3322635,5866000,11068335,0,
323300,Alvernia University,PA,1983784,3298556,5785000,11067340,0,
676000,University Of Maine - Augusta,ME,1351526,3537103,6178000,11066629,0,
220900,Smith College,MA,2119895,3123009,5820000,11062904,1913253000,
976700,Olive-Harvey College,IL,1429900,3488900,6127000,11045800,0,
1182400,Wisconsin Indianhead Technical College,WI,1505393,3454455,6049000,11008848,0,
146000,Trinity Washington University,DC,1960751,3299710,5742000,11002461,0,
157300,Georgia Southwestern State University,GA,1848045,3327789,5826000,11001834,0,
3544300,Atenas College,PR,2067059,3263200,5650000,10980259,0,
530600,Bates Technical College,WA,1684098,3335482,5943000,10962580,0,
211400,American International College,MA,1970878,3253225,5730000,10954103,0,
238200,Saint Olaf College,MN,2167063,3177701,5603000,10947764,0,
227700,Lake Michigan College,MI,1133204,3566805,6245000,10945009,0,
1067400,Texas Tech University Health Sciences Center,TX,2217206,3124943,5590000,10932149,0,
277900,Nazareth College Of Rochester,NY,2117252,3190890,5624000,10932142,71318000,
382600,West Virginia State University,WV,1650103,3356005,5908000,10914108,0,
220800,Simmons University,MA,2222441,3107695,5540000,10870136,195840000,
227300,Hope College,MI,2163878,3146684,5558000,10868562,232249000,
382800,West Virginia University - Parkersburg,WV,1753087,3316392,5786000,10855479,0,
340200,Bryant University,RI,2160764,3126451,5562000,10849215,184753000,
1167200,Mendocino College,CA,1309837,3442731,6073000,10825568,0,
170100,Kaskaskia College,IL,1449286,3394076,5982000,10825362,0,
1194100,American University Of Puerto Rico,PR,1861065,3275786,5673000,10809851,0,
754000,Missouri Baptist University,MO,1567808,3332982,5902000,10802790,0,
768400,Kishwaukee College,IL,1545526,3355410,5901000,10801936,0,
925900,Laramie County Community College,WY,1502654,3360314,5932000,10794968,0,
188900,Saint Ambrose University,IA,2054932,3163850,5573000,10791782,0,
150100,Florida Gateway College,FL,1498341,3377996,5915000,10791337,17831000,
3033000,Northern Marianas College,MP,1839331,3274565,5675000,10788896,0,
259800,Caldwell University,NJ,2028129,3184209,5567000,10779338,0,
757200,American Musical & Dramatic Academy,NY,2278035,3091878,5389000,10758913,0,
548900,Central Louisiana Technical Community College,LA,1462721,3372323,5911000,10746044,0,
348000,Bethel University,TN,2121073,4986720,3638000,10745793,0,
538000,Mid-State Technical College,WI,1528012,3350674,5860000,10738686,0,
1218200,Chattahoochee Valley Community College,AL,1645716,3294681,5734000,10674397,0,
681900,Blue Ridge Community College,VA,1862031,4228308,4562000,10652339,9499000,
861200,Robeson Community College,NC,1637622,3285022,5722000,10644644,0,
373700,Shenandoah University,VA,2040202,3089197,5503000,10632399,68105000,
683500,Dyersburg State Community College,TN,1495222,3316095,5797000,10608317,0,
294100,Lenoir-Rhyne University,NC,1941090,3141073,5523000,10605163,0,
216800,Cape Cod Community College,MA,1440010,3325139,5837000,10602149,0,
933300,University Of Illinois At Springfield,IL,1731887,3201018,5637000,10569905,0,
312100,Tiffin University,OH,1977210,3108766,5453000,10538976,0,
3957300,Blue Ridge Community And Technical College,WV,1185596,3363953,5989000,10538549,0,
183200,University Of Saint Francis,IN,1891129,3141501,5499000,10531630,0,
377200,Centralia College,WA,1477765,3276103,5767000,10520868,0,
330100,Moravian College,PA,2025895,3071936,5401000,10498831,0,
163300,Augustana College,IL,2091818,3038896,5347000,10477714,172846000,
214300,Curry College,MA,1934414,3097788,5445000,10477202,103667000,
1087900,Richland Community College,IL,1365509,3306518,5795000,10467027,0,
329600,Marywood University,PA,2020450,3048348,5366000,10434798,40574000,
210400,"University Of Maryland, Baltimore",MD,2077903,2965115,5384000,10427018,0,
363700,Jarvis Christian College,TX,1888040,3124313,5410000,10422353,0,
357100,Hardin-Simmons University,TX,1934006,3072013,5385000,10391019,194708000,
234700,Concordia University - Saint Paul,MN,1588736,3186977,5604000,10379713,0,
274400,Keuka College,NY,1981704,3051019,5325000,10357723,0,
372000,University Of Lynchburg,VA,1975980,3024446,5335000,10335426,112879000,
398600,Desales University,PA,1846942,3064499,5418000,10329441,91841000,
348500,Cumberland University,TN,1920642,3052125,5353000,10325767,0,
170500,Illinois Valley Community College,IL,1373121,3234228,5690000,10297349,0,
394600,University Of The Virgin Islands,VI,1713737,3121047,5446000,10280784,71684000,
332400,Mansfield University Of Pennsylvania,PA,1932117,3032041,5279000,10243158,0,
165700,Midwestern University,IL,2255126,2802472,5180000,10237598,170498000,
364500,Texas Wesleyan University,TX,1857910,3043923,5334000,10235833,59523000,
368300,Castleton University,VT,1756834,3074340,5400000,10231174,0,
235300,Gustavus Adolphus College,MN,2036930,2975740,5215000,10227670,203365000,
266400,Western New Mexico University,NM,1551426,3145154,5512000,10208580,0,
178100,Wheaton College,IL,2023744,2958197,5225000,10206941,503366000,
1536100,Guam Community College,GU,1149350,3303441,5747000,10199791,0,
292900,Gardner - Webb University,NC,1825407,3022376,5352000,10199783,0,
576100,L. E. Fletcher Technical Community College,LA,1375120,3215401,5608000,10198521,0,
265300,New Mexico Highlands University,NM,1699974,3085628,5407000,10192602,0,
938700,Perry Technical Institute,WA,1967635,2986793,5234000,10188428,0,
352600,Trevecca Nazarene University,TN,1718898,3063682,5401000,10183580,0,
172700,Moody Bible Institute,IL,1848490,3020458,5296000,10164948,0,
150500,Lynn University,FL,1935875,2968610,5244000,10148485,0,
375100,Patrick Henry Community College,VA,1483723,3155816,5507000,10146539,0,
327200,Harcum College,PA,1774344,3057654,5310000,10141998,0,
279000,Nyack College,NY,1773064,3041063,5318000,10132127,0,
316400,Oklahoma Baptist University,OK,1934138,2980341,5209000,10123479,130508000,
495100,University Of Texas Health Science Center At Houston,TX,1995703,2893112,5228000,10116815,0,
328200,Kings College,PA,1968517,2948842,5192000,10109359,0,
369100,Middlebury College,VT,1862094,2947241,5283000,10092335,1157786000,
679900,Craven Community College,NC,1509343,3112898,5451000,10073241,0,
537300,Lake Washington Institute Of Technology,WA,1558088,3070557,5440000,10068645,0,
280800,Daemen College,NY,1872946,2971689,5221000,10065635,0,
502700,Inter American University Of Puerto Rico - Barranquitas Campus,PR,3922288,6138003,0,10060291,0,
398800,Neumann University,PA,1758118,3015010,5285000,10058128,0,
2357600,Navajo Technical University,NM,1503703,3109240,5439000,10051943,0,
325200,Delaware Valley University,PA,1867829,2963697,5203000,10034526,33623000,
2315400,Northeast Texas Community College,TX,1140273,3231497,5655000,10026770,0,
962900,Mountain Empire Community College,VA,1394924,3133357,5473000,10001281,0,
345900,Black Hills State University,SD,1514973,3069733,5415000,9999706,0,
271200,D'Youville College,NY,1773370,2969354,5240000,9982724,0,
360000,Panola College,TX,1507332,3083051,5387000,9977383,0,
246300,Evangel University,MO,1850723,2955736,5167000,9973459,0,
314900,Southern Nazarene University,OK,1815175,2957714,5179000,9951889,0,
898800,Lurleen B. Wallace Community College,AL,1546138,3063215,5342000,9951353,0,
925600,Moraine Park Technical College,WI,1215286,3149222,5584000,9948508,0,
112200,Biola University,CA,3922227,6020986,0,9943213,0,
259100,Plymouth State University Of The University System Of New Hampshire,NH,3950921,5982786,0,9933707,0,
186700,Grand View University,IA,1805328,2955616,5164000,9924944,25734000,
286700,Suny Fulton-Montgomery Community College,NY,1635420,3014275,5268000,9917695,0,
531300,North Central State College,OH,1410128,3087374,5415000,9912502,0,
324100,Cabrini University,PA,2005185,2866887,5026000,9898072,0,
905800,Bethel University,MN,2452828,3803833,3638000,9894661,0,
277800,Mount Saint Mary College,NY,1809886,2927444,5135000,9872330,5998000,
672000,College Of Alameda,CA,1049170,3172271,5642000,9863441,0,
2282800,Inter American University Of Puerto Rico - Fajardo Campus,PR,3814392,6041453,0,9855845,0,
213900,Clark University,MA,1940791,2852424,5055000,9848215,438767000,
222400,Wellesley College,MA,1970468,2841471,5011000,9822939,2173415000,
696200,Hazard Community And Technical College,KY,1248333,3109690,5451000,9809023,0,
166600,Concordia University,IL,1875573,3094265,4831000,9800838,88859000,
205700,Allegany College Of Maryland,MD,1494165,3023670,5283000,9800835,0,
990300,Vance - Granville Community College,NC,1453645,3033363,5310000,9797008,0,
709900,Virginia Highlands Community College,VA,1398769,3055930,5335000,9789699,0,
238500,Northland Community And Technical College,MN,1355409,3053777,5361000,9770186,0,
2278100,Santa Fe Community College,NM,1219106,3085414,5457000,9761520,0,
311600,University Of Rio Grande,OH,1717045,2931560,5112000,9760605,0,
339600,Wilson College,PA,843869,1498967,7417000,9759836,55338000,
2052200,Black River Technical College,AR,1643629,2961823,5154000,9759452,0,
134200,Whittier College,CA,1879550,2866302,5011000,9756852,112868000,
183600,Saint Mary'S College,IN,1201641,1886322,6662000,9749963,201649000,
238000,Saint Mary'S University Of Minnesota,MN,1661096,2884483,5163000,9708579,61788000,
297000,Surry Community College,NC,1433250,3021468,5245000,9699718,0,
4203400,Arkansas State University - Newport,AR,1266638,3055614,5377000,9699252,0,
2185400,Saint Augustine College,IL,1496982,3001085,5201000,9699067,0,
158800,Piedmont College,GA,1766322,2872263,5060000,9698585,0,
231700,Southwestern Michigan College,MI,1522115,2956093,5166000,9644208,0,
527700,Eastern Maine Community College,ME,1426773,2974826,5230000,9631599,0,
341800,Anderson University,SC,2092286,3389001,4145000,9626287,0,
329000,Lincoln University,PA,3494532,5521219,600000,9615751,0,
214100,College Of The Holy Cross,MA,1919146,2750691,4939000,9608837,785852000,
260800,Georgian Court University,NJ,1690335,2873205,5041000,9604540,54858000,
855700,Nash Community College,NC,1299061,3007699,5276000,9582760,0,
313500,Walsh University,OH,1831514,2803207,4933000,9567721,0,
231600,Siena Heights University,MI,1545879,2914880,5095000,9555759,0,
803800,Middlesex Community College,CT,1323379,2987020,5242000,9552399,0,
383200,Alverno College,WI,1738517,2843337,4957000,9538854,0,
323800,Bucknell University,PA,1946454,2725476,4863000,9534930,866835000,
3170300,Texas A & M University - Texarkana,TX,1525001,2916364,5093000,9534365,0,
294700,Mitchell Community College,NC,1393025,2950186,5181000,9524211,0,
3542400,Copper Mountain College,CA,1372962,2973281,5176000,9522243,0,
288000,Ulster County Community College,NY,1387075,2929602,5170000,9486677,0,
147800,Edward Waters College,FL,1361209,2936739,5183000,9480948,0,
285900,Suny College Of Agriculture & Technology At Morrisville,NY,3527241,5952000,0,9479241,0,
289500,Vassar College,NY,1835621,2768070,4871000,9474691,1117380000,
121800,Loma Linda University,CA,1777517,2743699,4927000,9448216,1076898000,
2362100,Full Sail University,FL,9445834,0,0,9445834,0,
392800,Casper College,WY,1370012,2913330,5146000,9429342,0,
229300,Lake Superior State University,MI,1602263,2845606,4978000,9425869,0,
2107800,University Of Hawaii - West Oahu,HI,1395000,2916448,5112000,9423448,0,
1040200,Dakota County Technical College,MN,1467178,2887495,5068000,9422673,0,
103300,Oakwood University,AL,1573749,2860345,4984000,9418094,0,
357700,Huston - Tillotson University,TX,1630192,2823993,4953000,9407185,0,
1275000,Edison State Community College,OH,1229604,2956649,5208000,9394253,0,
791200,Thaddeus Stevens College Of Technology,PA,1866667,2740187,4771000,9377854,0,
134500,Adams State University,CO,1568914,2825647,4959000,9353561,0,
316300,Northwestern Oklahoma State University,OK,1506494,2857219,4988000,9351713,0,
2100500,Universal Technical Institute,AZ,9330780,0,0,9330780,0,
976900,Metropolitan College Of New York,NY,1690962,2786721,4850000,9327683,0,
223500,Albion College,MI,1831231,2729884,4760000,9321115,161113000,
824600,Dine College,AZ,1346931,2909862,5060000,9316793,0,
3948300,Harrisburg University Of Science And Technology,PA,1536586,2772298,5006000,9314884,0,
697300,Canada College,CA,1098544,2937222,5275000,9310766,0,
327000,Gwynedd Mercy University,PA,1673075,2765755,4871000,9309830,0,
335000,University Of The Arts (The),PA,1825665,2708958,4751000,9285623,0,
2070500,Concordia University,CA,1723598,2726592,4831000,9281190,88859000,
385400,Lakeland University,WI,1361111,2874606,5043000,9278717,17731000,
223400,Adrian College,MI,1752186,2735888,4783000,9271074,0,
253100,Montana Technological University,MT,1676199,2747518,4835000,9258717,0,
377000,Big Bend Community College,WA,1473837,2822644,4950000,9246481,0,
1287000,Southern State Community College,OH,1319577,2875872,5048000,9243449,0,
1036300,Western Nevada College,NV,1363469,2850200,5011000,9224669,0,
228200,Madonna University,MI,1517426,2793087,4913000,9223513,0,
166400,University Of St. Francis,IL,1539673,2768175,4901000,9208848,20877000,
1002700,James A. Rhodes State College,OH,1292073,2860797,5054000,9206870,0,
393000,Northern Wyoming Community College District,WY,1175360,2886992,5129000,9191352,0,
212200,Bay Path University,MA,1431166,2817463,4941000,9189629,0,
1226100,North Arkansas College,AR,1444804,2820340,4913000,9178144,0,
901000,Madisonville Community College,KY,1069051,2936703,5168000,9173754,0,
3083700,Galen Health Institutes,KY,9167121,0,0,9167121,0,
233500,Riverland Community College,MN,1272243,2860474,5030000,9162717,0,
198000,University Of Pikeville,KY,1566531,2756839,4838000,9161370,0,
282900,St. Lawrence University,NY,1808349,2660768,4691000,9160117,315661000,
357300,Hill College,TX,1336557,4231488,3581000,9149045,217240000,
271300,Dominican College Of Blauvelt,NY,1684221,2710969,4748000,9143190,0,
319700,Lewis & Clark College,OR,1827087,2625573,4680000,9132660,246794000,
4229500,Texas A&M University - Central Texas,TX,1318324,2845060,4969000,9132384,0,
680700,Community College Of Beaver County,PA,1381963,2813941,4924000,9119904,0,
381300,Glenville State College,WV,1440768,2802178,4876000,9118946,0,
196800,Kentucky State University,KY,1372077,2817902,4926000,9115979,0,
370400,Bridgewater College,VA,1799980,2653699,4645000,9098679,95758000,
308400,Muskingum University,OH,1596789,2723866,4776000,9096655,79461000,
231800,Spring Arbor University,MI,1581268,2713148,4785000,9079416,19244000,
2241900,Commonwealth Of Puerto Rico Department Of Education,PR,3315937,5761089,0,9077026,0,
350100,Lemoyne - Owen College,TN,1660276,2713735,4700000,9074011,0,
229400,Monroe County Community College,MI,1300516,2818764,4951000,9070280,0,
276000,Manhattanville College,NY,1721825,2659835,4686000,9067660,31170000,
293100,Guilford College,NC,1682787,2684520,4697000,9064307,78308000,
172200,Mckendree University,IL,1636302,2686549,4713000,9035851,0,
298300,Wilkes Community College,NC,1401082,2753588,4824000,8978670,0,
182100,Marian University,IN,1805271,2899595,4269000,8973866,0,
323000,Allegheny College,PA,1743082,2629976,4598000,8971058,230453000,
373600,Roanoke College,VA,1777599,2551224,4628000,8956823,148794000,
3120300,Collegeamerica - Flagstaff,AZ,1792797,2524521,4612000,8929318,0,
1001000,American Samoa Community College,AS,1617885,2669776,4638000,8925661,0,
205000,University Of New England,ME,1365831,2688237,4871000,8925068,39304000,
1302900,Boricua College,NY,1744981,2622688,4550000,8917669,0,
146800,Saint Thomas University,FL,1296380,2737055,4874000,8907435,0,
392500,University Of Wisconsin - Superior,WI,1488367,2694797,4723000,8906164,0,
304200,Denison University,OH,1766023,2541005,4598000,8905028,877592000,
303600,Franciscan University Of Steubenville,OH,1604718,2635646,4659000,8899364,0,
348200,Christian Brothers University,TN,1600690,2647314,4641000,8889004,0,
2282700,Inter American University Of Puerto Rico - Guayama Campus,PR,3353951,5534682,0,8888633,0,
3100400,Coconino County Community College,AZ,1104730,2805311,4970000,8880041,0,
2348500,Lamar State College - Port Arthur,TX,1056684,2846257,4975000,8877941,0,
267800,Bryant & Stratton College,NY,8877497,0,0,8877497,0,
2362000,Universal Technical Institute,TX,8848799,0,0,8848799,0,
728700,Brazosport College,TX,1228723,2738926,4874000,8841649,0,
3066500,Southeastern Technical College,GA,1258784,2759696,4811000,8829480,0,
355700,Concordia University Texas,TX,1512530,2657370,4658000,8827900,0,
1011100,Cerro Coso Community College,CA,908958,2844359,5069000,8822317,0,
276900,Marymount Manhattan College,NY,1701441,2575254,4517000,8793695,0,
160500,Chaminade University Of Honolulu,HI,1482800,2653900,4649000,8785700,23399000,
885500,Edgecombe Community College,NC,1239795,2752568,4793000,8785363,0,
144300,Gallaudet University,DC,1642996,2601481,4528000,8772477,188190000,
314300,Wittenberg University,OH,1728770,2558869,4484000,8771639,119174000,
113300,California Lutheran University,CA,3451376,5298324,0,8749700,108602000,
212300,Becker College,MA,1645170,2580575,4514000,8739745,0,
4038600,Bridgevalley Community And Technical College,WV,1445025,2659232,4634000,8738257,0,
110500,Shorter College,AR,1097484,2773066,4862000,8732550,0,
1115000,Asnuntuck Community College,CT,1215438,2735540,4770000,8720978,0,
1092200,University Of Puerto Rico - Utuado,PR,1600359,2606099,4514000,8720458,0,
1465900,Oglala Lakota College,SD,1297595,2709233,4712000,8718828,0,
285100,Suny College Of Environment Science & Forestry,NY,1681739,2550924,4483000,8715663,0,
255500,Nebraska Wesleyan University,NE,1382752,2644968,4687000,8714720,0,
1281300,John Wood Community College,IL,1245792,2717630,4749000,8712422,0,
711900,Rend Lake College,IL,1182264,2719542,4804000,8705806,0,
210900,Mcdaniel College,MD,1629536,2549733,4498000,8677269,134764000,
497200,Galveston College,TX,1212226,2698376,4735000,8645602,0,
377900,Grays Harbor College,WA,1303394,2671568,4669000,8643962,0,
187700,North Iowa Area Community College,IA,1293311,2656684,4684000,8633995,32433000,
294400,Mars Hill University,NC,1707699,2527689,4395000,8630388,0,
243300,Rust College,MS,1359587,2646031,4615000,8620618,43445000,
179500,University Of Evansville,IN,1681651,2503846,4416000,8601497,85667000,
356400,East Texas Baptist University,TX,1556715,2563621,4475000,8595336,0,
968400,Blue Ridge Community College,NC,1426892,2598523,4562000,8587415,9499000,
808200,Cleveland Community College,NC,1214574,2678304,4691000,8583878,0,
366900,Wiley College,TX,1538638,2577092,4468000,8583730,0,
328000,Keystone College,PA,1425853,2577532,4574000,8577385,0,
226600,Cornerstone University,MI,1514292,2564593,4495000,8573885,10434000,
536000,Tennessee College Of Applied Technology-Memphis,TN,1453214,2595530,4522000,8570744,0,
4038500,Pierpont Community & Technical College,WV,1154797,2698353,4712000,8565150,0,
371100,Ferrum College,VA,1673615,2516615,4370000,8560230,53517000,
212100,Babson College,MA,1761990,2433726,4362000,8557716,457670000,
544700,Randolph Community College,NC,1264255,2648434,4637000,8549689,0,
161500,University Of Hawaii Maui College,HI,1187907,2668102,4689000,8545009,0,
319300,Eastern Oregon University,OR,1158327,2679451,4700000,8537778,0,
215800,Lasell University,MA,1647941,2497307,4391000,8536248,45910000,
103800,Snead State Community College,AL,1239198,2642522,4633000,8514720,0,
344000,Newberry College,SC,1592676,2521835,4391000,8505511,0,
222700,Wheaton College,MA,1338514,1935305,5225000,8498819,503366000,
368400,Champlain College,VT,1368260,2577443,4549000,8494703,0,
166900,Danville Area Community College,IL,942073,2719814,4817000,8478887,0,
324500,Chestnut Hill College,PA,1574651,2503187,4378000,8455838,0,
2074800,Life University,GA,1677181,2440082,4338000,8455263,0,
143300,Wesley College,DE,1494069,2536920,4418000,8448989,0,
753200,Finger Lakes Community College - Suny Office Of Community Colleges,NY,2655728,5791370,0,8447098,0,
726500,Carl Sandburg College,IL,1175052,2636911,4608000,8419963,0,
326500,Franklin & Marshall College,PA,1692121,2412793,4308000,8412914,354783000,
254400,Doane University,NE,1538922,2483317,4387000,8409239,113944000,
295700,Queens University Of Charlotte,NC,1532289,2483916,4379000,8395205,150237000,
376100,Wytheville Community College,VA,1217475,2607176,4569000,8393651,0,
207300,Goucher College,MD,1575324,2465931,4340000,8381255,203430000,
341100,Salve Regina University,RI,1715409,2407367,4251000,8373776,63790000,
281700,St. Bonaventure University,NY,1592629,2450106,4316000,8358735,74402000,
270800,Barnard College,NY,1712643,2395232,4239000,8346875,363623000,
349600,King University,TN,1405253,2586230,4349000,8340483,0,
460800,Barton County Community College,KS,896181,2662852,4773000,8332033,0,
294500,Meredith College,NC,1674515,2411617,4229000,8315132,114786000,
364700,Trinity University,TX,1665507,2394160,4239000,8298667,1280248000,
167600,Elmhurst College,IL,3320646,4964496,0,8285142,112339000,
200100,Thomas More University,KY,1329216,2520355,4430000,8279571,0,
324700,Misericordia University,PA,1536398,2440041,4303000,8279439,54532000,
343400,Furman University,SC,1656467,2378551,4229000,8264018,694272000,
326800,Gettysburg College,PA,1656033,2384833,4223000,8263866,330714000,
137200,Western Colorado University,CO,1353339,2489853,4420000,8263192,0,
101500,Enterprise State Community College,AL,1240737,2555815,4465000,8261552,0,
322200,Umpqua Community College,OR,1121853,2593396,4533000,8248249,0,
407200,Northwood University,MI,1358224,2497291,4391000,8246515,97869000,
525800,Hawaii Community College,HI,1147226,2574000,4510000,8231226,0,
1031900,Fortis Institute - Towson,MD,8227327,0,0,8227327,0,
916000,Rappahannock Community College,VA,1149192,2564530,4513000,8226722,0,
161200,Honolulu Community College,HI,1107387,2568029,4547000,8222416,0,
218000,Massachusetts College Of Art And Design,MA,1510265,2432464,4278000,8220729,0,
376700,Virginia Wesleyan University,VA,1493207,2448369,4276000,8217576,0,
316500,Oklahoma Christian University,OK,1619172,2388752,4208000,8215924,0,
526300,Minnesota West Community And Technical College,MN,1072094,2583493,4551000,8206587,0,
328500,Lancaster Bible College,PA,1389655,2477282,4338000,8204937,0,
270100,Colgate University,NY,1636002,2361476,4202000,8199478,950360000,
570700,Southeast Arkansas College,AR,1187530,2560591,4450000,8198121,0,
155600,Brenau University,GA,1283197,2507744,4393000,8183941,49482000,
191900,Garden City Community College,KS,1282005,2506940,4387000,8175945,0,
219200,Mount Holyoke College,MA,1588803,2374484,4193000,8156287,794204000,
184800,Southeastern Community College,IA,1155058,2539510,4456000,8150568,0,
191000,Coffeyville Community College,KS,1219871,2519186,4411000,8150057,0,
389200,Saint Norbert College,WI,1595105,2367509,4173000,8135614,0,
919400,Lakeshore Technical College,WI,977816,2597047,4559000,8133863,0,
281400,Skidmore College,NY,1640633,2340853,4152000,8133486,384280000,
128100,William Jessup University,CA,1486736,2407561,4232000,8126297,0,
243900,Tougaloo College,MS,1487317,2310909,4325000,8123226,0,
234600,Concordia College - Moorhead,MN,1590356,2360701,4166000,8117057,0,
1072400,Albizu University,PR,1453598,2398440,4264000,8116038,0,
310900,Ohio Wesleyan University,OH,1602505,2341490,4168000,8111995,243083000,
222900,Williams College,MA,1564588,2369232,4174000,8107820,2888962000,
154000,Webber International University,FL,1470540,2417415,4209000,8096955,0,
180000,Grace College And Theological Seminary,IN,1551701,2375929,4169000,8096630,0,
3155500,Oconee Fall Line Technical College,GA,1152438,2527282,4402000,8081720,0,
170600,Lake Forest College,IL,1546268,2375182,4160000,8081450,90630000,
352700,Tusculum University,TN,1493995,2397431,4187000,8078426,0,
178500,Anderson University,IN,1564159,2367509,4145000,8076668,0,
181100,Indiana University - East,IN,1062722,2538074,4457000,8057796,0,
330400,Muhlenberg College,PA,1619907,2258253,4138000,8016160,288974000,
638500,Chamberlain University,IL,8007329,0,0,8007329,0,
4041400,Mountwest Community And Technical College,WV,1129207,2495734,4372000,7996941,0,
330300,Carlow University,PA,1343715,2413761,4229000,7986476,0,
190000,William Penn University,IA,1485340,2371372,4129000,7985712,0,
155400,Berry College,GA,1589811,2313835,4079000,7982646,1058605000,
227900,Lawrence Technological University,MI,1462382,2348383,4154000,7964765,0,
549800,Wichita State University Campus Of Applied Sciences And Technology,KS,2383798,5577556,0,7961354,0,
336800,Saint Vincent College & Seminary,PA,1605435,2296210,4036000,7937645,0,
316600,Oklahoma City University,OK,1536667,2303854,4097000,7937521,0,
170900,Lincoln College,IL,1279507,2432172,4221000,7932679,0,
273100,Hobart And William Smith Colleges,NY,1571579,2298243,4052000,7921822,229107000,
708500,Mount Vernon Nazarene University,OH,1330478,2390828,4194000,7915306,0,
358600,Lubbock Christian University,TX,1422450,2357712,4130000,7910162,22015000,
314200,Wilmington College,OH,1514460,2330038,4062000,7906498,0,
343900,Morris College,SC,1481212,2350669,4070000,7901881,0,
211500,Amherst College,MA,1574582,2283237,4012000,7869819,2473283000,
315800,Murray State College,OK,1167810,2437012,4258000,7862822,0,
324300,Cedar Crest College,PA,1526417,2304150,4030000,7860567,36651000,
179200,Depauw University,IN,1574528,2253903,4007000,7835431,730341000,
527100,Southcentral Kentucky Community And Technical College,KY,2424487,5410058,0,7834545,0,
997500,Northwest Louisiana Technical Community College,LA,1136669,2440885,4244000,7821554,0,
147200,Chipola College,FL,1208491,2398117,4202000,7808608,0,
3029700,Universal Technology College Of Puerto Rico,PR,1432599,2252260,4117000,7801859,0,
2110200,Columbia College Hollywood,CA,1405837,2109386,4285000,7800223,0,
148700,Eckerd College,FL,1561944,2238201,3999000,7799145,60579000,
322100,Treasure Valley Community College,OR,997664,2464882,4327000,7789546,0,
100700,Central Alabama Community College,AL,1222052,2380348,4163000,7765400,0,
298200,Western Piedmont Community College,NC,1157050,2272532,4328000,7757582,0,
234100,College Of Saint Benedict,MN,1572552,2204200,3966000,7742752,83506000,
247900,Lincoln University,MO,2565804,4575902,600000,7741706,0,
244900,Avila University,MO,1391760,2287906,4059000,7738666,0,
563800,Downey Adult School,CA,1232716,2288989,4214000,7735705,0,
248900,Missouri Valley College,MO,1322917,2331466,4076000,7730383,0,
2568800,Sussex County Community College,NJ,1156835,2381665,4191000,7729500,0,
347000,South Dakota School Of Mines & Technology,SD,1455698,2264943,4008000,7728641,65076000,
1303900,South University,GA,7726176,0,0,7726176,0,
341700,Allen University,SC,1589675,2243073,3885000,7717748,0,
1174500,Ohio Technical College,OH,671034,0,7042000,7713034,0,
137400,Albertus Magnus College,CT,1362920,2304400,4023000,7690320,0,
154700,Point University,GA,1214025,2353229,4121000,7688254,64777000,
185400,Coe College,IA,1525647,2234501,3928000,7688148,0,
299400,Minot State University,ND,1275782,2315110,4083000,7673892,0,
296800,Saint Augustine'S University,NC,1450038,2276686,3945000,7671724,0,
361600,Southwestern Assemblies Of God University,TX,1215532,2351126,4103000,7669658,0,
296400,Southeastern Community College,NC,1118302,2082781,4456000,7657083,0,
281200,Trocaire College,NY,1147253,2372371,4130000,7649624,0,
336200,Seton Hill University,PA,1266845,2298815,4079000,7644660,0,
982600,Kennebec Valley Community College,ME,979695,2418076,4239000,7636771,0,
3025500,Mech Tech College,PR,7627631,0,0,7627631,0,
182000,Manchester University,IN,1511452,2188041,3927000,7626493,64470000,
291000,Belmont Abbey College,NC,1407500,2247933,3933000,7588433,0,
3100700,Carroll Community College,MD,1104882,2336256,4137000,7578138,0,
364100,Texas Lutheran University,TX,1408194,2237611,3910000,7555805,94530000,
336600,Saint Francis University,PA,1409610,2214219,3927000,7550829,52713000,
770700,Columbia College,CA,994576,2374255,4172000,7540831,168869000,
379900,Walla Walla University,WA,1437520,2200713,3879000,7517233,28836000,
322000,Southwestern Oregon Community College,OR,1081690,2334480,4095000,7511170,0,
471100,State Technical College Of Missouri,MO,1364179,2233682,3910000,7507861,0,
254100,Concordia University,NE,1017489,1656961,4831000,7505450,88859000,
380900,Bluefield State College,WV,1296174,2258274,3928000,7482448,0,
270900,Concordia College,NY,813395,2487042,4166000,7466437,143479000,
559400,Erwin Technical College,FL,967210,2355228,4143000,7465438,0,
221700,Stonehill College,MA,1498782,2143106,3820000,7461888,217240000,
381800,University Of Charleston,WV,1222988,2258339,3970000,7451327,0,
226200,Kettering University,MI,1457033,2156693,3836000,7449726,90353000,
223800,Andrews University,MI,1236555,2227235,3980000,7443790,0,
335300,University Of The Sciences In Philadelphia,PA,1475914,2059170,3905000,7440084,162527000,
286000,Adirondack Community College - Suny Office Of Community Colleges,NY,2558377,4876146,0,7434523,0,
291400,Catawba College,NC,1407154,2191691,3826000,7424845,0,
308500,Notre Dame College Of Ohio,OH,1274119,2238457,3912000,7424576,0,
339100,Waynesburg University,PA,1442703,2164737,3813000,7420440,0,
235800,Macalester College,MN,1483970,2141894,3790000,7415864,770782000,
104400,Stillman College,AL,1206208,2281898,3926000,7414106,0,
830800,Cecil College,MD,1115623,2282889,4015000,7413512,0,
249900,Rockhurst University,MO,1169737,2786245,3455000,7410982,36471000,
386100,Marian University,WI,1147099,1984559,4269000,7400658,0,
322700,Willamette University,OR,1509234,2123316,3761000,7393550,262124000,
280500,Roberts Wesleyan College,NY,1381405,2180388,3830000,7391793,0,
257500,Franklin Pierce University,NH,1400647,2169855,3819000,7389502,0,
218700,Massachusetts College Of Liberal Arts,MA,1309397,2202852,3859000,7371249,13544000,
188700,Simpson College,IA,1453050,2148524,3760000,7361574,0,
328800,Lebanon Valley College,PA,1442705,2135202,3781000,7358907,71832000,
308600,Oberlin College,OH,1457347,2088700,3805000,7351047,943469000,
329300,Lycoming College,PA,1392658,2156676,3796000,7345334,0,
4210100,Stella And Charles Guttman Community College,NY,1228352,2231778,3872000,7332130,0,
867700,Northwest State Community College,OH,962933,2284428,4075000,7322361,0,
384800,Edgewood College,WI,1402919,2142831,3774000,7319750,0,
703200,Midamerica Nazarene University,KS,1199713,2212640,3907000,7319353,0,
124900,Occidental College,CA,1474674,2114553,3730000,7319227,448095000,
174200,Illinois Eastern Community Colleges - Olney Central College,IL,737002,6578576,0,7315578,0,
259900,Centenary University,NJ,1350523,2161482,3792000,7304005,7330000,
735000,Anoka Technical College,MN,1108759,2251405,3943000,7303164,0,
102900,University Of Mobile,AL,1257422,2193784,3843000,7294206,0,
110200,Ouachita Baptist University,AR,1344385,2155889,3781000,7281274,0,
188000,Mount Mercy University,IA,1221083,2194529,3863000,7278612,0,
2063500,Coastline Community College,CA,634209,2394934,4249000,7278143,0,
1025600,Benedictine College,KS,1420495,2118571,3737000,7276066,0,
265500,New Mexico Junior College,NM,1121004,2230402,3923000,7274406,0,
340900,Rhode Island School Of Design,RI,1464915,2090083,3711000,7265998,349660000,
110000,John Brown University,AR,1316339,2154561,3794000,7264900,125570000,
223600,Alma College,MI,1429939,2083777,3744000,7257716,0,
379700,University Of Puget Sound,WA,1418056,2104744,3733000,7255800,380507000,
289900,Wagner College,NY,1488258,2079612,3679000,7246870,77564000,
4254400,Arkansas State University - Mountain Home,AR,1059570,2253796,3926000,7239366,0,
711100,North Country Community College,NY,1111281,2219613,3887000,7217894,0,
158900,Reinhardt University,GA,1278399,2157472,3768000,7203871,0,
265400,New Mexico Institute Of Mining & Technology,NM,1353197,2121204,3727000,7201401,0,
216700,Berkshire Community College,MA,1052143,2232738,3904000,7188881,0,
3368300,Midwest Technical Institute,IL,7164512,0,0,7164512,0,
184700,Buena Vista University,IA,1123792,2192341,3827000,7143133,136568000,
192100,Highland Community College,KS,967270,2315079,3852000,7134349,0,
230800,Olivet College,MI,1315786,2121989,3695000,7132775,0,
303700,College Of Wooster (The),OH,1417795,2064878,3647000,7129673,0,
379400,Saint Martin'S University,WA,1252197,2133004,3738000,7123201,0,
464100,Dunwoody College Of Technology,MN,1304369,2117843,3698000,7120212,0,
360300,Ranger College,TX,1047733,2201022,3868000,7116755,0,
2358200,Lamar State College - Orange,TX,1043319,2206109,3865000,7114428,0,
325300,Dickinson College,PA,1436068,2030560,3640000,7106628,455442000,
191600,Fort Scott Community College,KS,1021526,2205875,3868000,7095401,0,
285600,Suny College Of Agriculture & Technology At Cobleskill,NY,2747860,4345324,0,7093184,0,
170000,Judson University,IL,1311084,2103474,3673000,7087558,0,
158600,Oglethorpe University,GA,1279508,2105854,3687000,7072362,0,
294300,Louisburg College,NC,1342704,2097680,3630000,7070384,0,
187400,Luther College,IA,1380684,2050589,3621000,7052273,168780000,
391100,Viterbo University,WI,1279908,2082039,3687000,7048947,55673000,
214000,College Of Our Lady Of The Elms,MA,1298135,2089016,3658000,7045151,0,
502200,Universidad Central De Bayamon,PR,958454,2224465,3862000,7044919,0,
303300,Mount St. Joseph University,OH,1282973,2083359,3675000,7041332,0,
295500,Pfeiffer University,NC,1274850,2087406,3678000,7040256,0,
343100,Converse College,SC,1326683,2068714,3644000,7039397,78372000,
159100,Shorter University,GA,1208080,2118322,3696000,7022402,0,
349200,Freed Hardeman University,TN,1353998,2051737,3614000,7019735,0,
2074600,South Arkansas Community College,AR,1071512,2161063,3772000,7004575,0,
104100,Spring Hill College,AL,1372682,2046512,3581000,7000194,24768000,
178700,Bethel University,IN,1269847,2081394,3638000,6989241,0,
344700,Spartanburg Methodist College,SC,1322353,2070489,3595000,6987842,22069000,
373800,Southern Virginia University,VA,1257205,2088697,3635000,6980902,0,
294000,Lenoir Community College,NC,970886,2181419,3827000,6979305,0,
535900,Tennessee College Of Applied Technology - Nashville,TN,1038538,1970898,3960000,6969436,0,
343000,Columbia College,SC,1002296,1793174,4172000,6967470,168869000,
285300,Suny Maritime College,NY,1400241,1977394,3582000,6959635,0,
168100,Highland Community College,IL,911809,2194108,3852000,6957917,0,
3037500,Hodges University,FL,1029439,2162207,3763000,6954646,0,
1113300,College Of Eastern Idaho,ID,985694,2172759,3793000,6951453,0,
350500,Maryville College,TN,1401887,2010056,3507000,6918943,0,
186600,Graceland University,IA,1147199,2070241,3696000,6913440,0,
326200,Elizabethtown College,PA,1350544,2012838,3546000,6909382,83797000,
4192800,Be'Er Yaakov Talmudic Seminary,NY,1335069,2035253,3524000,6894322,0,
377700,Heritage University,WA,1283643,2046489,3564000,6894132,0,
328400,Lafayette College,PA,1391019,1970926,3521000,6882945,832068000,
237100,University Of Northwestern- St Paul,MN,1138110,2064141,3674000,6876251,0,
3483500,Cascadia College,WA,1156230,2051497,3665000,6872727,0,
307200,Malone University,OH,1247915,2039528,3579000,6866443,0,
990200,Sheridan Technical College,FL,1063091,2103860,3694000,6860951,0,
789200,Sampson Community College,NC,1033931,2114437,3705000,6853368,0,
365100,University Of Dallas,TX,1277096,2011032,3556000,6844128,0,
3128100,College Of Health Care Professions (The),TX,6835962,0,0,6835962,0,
215300,Gordon College,MA,1311252,1994086,3525000,6830338,0,
208000,Maryland Institute College Of Art,MD,1318621,1985633,3520000,6824254,94441000,
2576900,Charter College,WA,6816451,0,0,6816451,0,
141400,Trinity College,CT,1376444,1953790,3479000,6809234,623153000,
169600,Illinois Wesleyan University,IL,1341680,1982260,3484000,6807940,206191000,
190300,Baker University,KS,1134284,2045379,3617000,6796663,0,
465000,Chesapeake College,MD,917533,2135148,3742000,6794681,0,
798500,South Piedmont Community College,NC,977809,2100498,3704000,6782307,0,
207600,Hood College,MD,1265284,1998556,3517000,6780840,106905000,
170400,Knox College,IL,1328070,1982465,3466000,6776535,170174000,
134300,Woodbury University,CA,1199479,2029312,3542000,6770791,0,
214700,Emmanuel College,MA,1651975,2584736,2519000,6755711,151725000,
306900,Lourdes University,OH,1108640,2044801,3600000,6753441,0,
237900,Saint John'S University,MN,1357136,1933994,3460000,6751130,208738000,
368100,Westminster College,UT,1897239,2895045,1942000,6734284,116515000,
136800,Trinidad State Junior College,CO,1038406,2068234,3622000,6728640,0,
100800,Athens State University,AL,845033,2140301,3741000,6726334,0,
293400,Isothermal Community College,NC,1012055,2073934,3632000,6717989,0,
359100,Mcmurry University,TX,1136612,2031666,3540000,6708278,94536000,
372300,Mary Baldwin University,VA,1120685,2033234,3554000,6707919,30179000,
378300,Northwest University,WA,1075562,2038034,3582000,6695596,0,
1257400,Ringling College Of Art And Design,FL,1273220,1966822,3448000,6688042,53537000,
3106000,Missouri State University - West Plains,MO,960166,2082884,3643000,6686050,0,
3180400,Pennsylvania Highlands Community College,PA,880286,2100714,3704000,6685000,0,
326700,Geneva College,PA,1347254,1936527,3397000,6680781,0,
677700,Flathead Valley Community College,MT,925144,2079030,3673000,6677174,0,
303500,Ohio Dominican University,OH,1186525,1991363,3497000,6674888,20161000,
358400,Letourneau University,TX,1050372,2033240,3589000,6672612,22055000,
338900,Washington And Jefferson College,PA,1334327,1936173,3401000,6671500,0,
119600,Dominican University Of California,CA,1244783,1962413,3457000,6664196,0,
3115500,Adventhealth University,FL,1126242,2008706,3527000,6661948,0,
201400,Louisiana State University Health Sciences Center,LA,1391236,1881142,3381000,6653378,0,
101900,Huntingdon College,AL,1225333,1976343,3444000,6645676,0,
253900,Chadron State College,NE,1081277,2016084,3541000,6638361,0,
813300,Zane State College,OH,1002163,2040434,3590000,6632597,0,
370900,Emory & Henry College,VA,1262240,1941855,3396000,6600095,0,
2098800,University Of Phoenix,AZ,6589433,0,0,6589433,0,
220600,Regis College,MA,1025140,2001630,3559000,6585770,0,
272900,Hartwick College,NY,1271783,1933993,3377000,6582776,76792000,
1050900,Hallmark University,TX,1304065,1925928,3348000,6577993,0,
354300,Austin College,TX,1342606,1904577,3330000,6577183,149667000,
827800,Terra State Community College,OH,852360,2073348,3642000,6567708,0,
219700,Nichols College,MA,1236801,1932689,3393000,6562490,17345000,
175200,Sauk Valley Community College,IL,926411,2045042,3590000,6561453,0,
140900,University Of Saint Joseph,CT,1158343,1948054,3453000,6559397,34781000,
2242700,Berkeley City College,CA,1844524,4706915,0,6551439,0,
398700,La Roche University,PA,1205918,1942542,3401000,6549460,0,
174800,Rockford University,IL,1225910,1931238,3382000,6539148,0,
361000,Schreiner University,TX,1181201,1944297,3407000,6532498,0,
315500,Eastern Oklahoma State College,OK,937568,2035000,3554000,6526568,0,
162400,Northwest Nazarene University,ID,820668,2039850,3661000,6521518,0,
3440300,Baptist Memorial College Of Health Sciences,TN,1141951,1959332,3412000,6513283,0,
321200,Pacific University,OR,2323471,3403723,784000,6511194,124901000,
318600,Blue Mountain Community College,OR,966862,2004616,3527000,6498478,0,
730300,Lincoln Technical Institute,CT,6495045,0,0,6495045,0,
258300,Great Bay Community College,NH,870169,2028155,3584000,6482324,0,
229900,North Central Michigan College,MI,835428,2034633,3605000,6475061,0,
187300,Loras College,IA,1272730,1883667,3307000,6463397,41584000,
189600,Wartburg College,IA,1289269,1876934,3297000,6463203,0,
216900,Greenfield Community College,MA,887515,2023815,3547000,6458330,0,
360200,Paul Quinn College,TX,1163719,1937535,3357000,6458254,0,
1246100,Lincoln Technical Institute,NJ,6452823,0,0,6452823,0,
808700,Montgomery Community College,NC,382976,799600,5268000,6450576,0,
255300,Midland University,NE,1102337,1920489,3403000,6425826,0,
200700,Louisiana College,LA,1147506,1920379,3356000,6423885,0,
1053000,Quinebaug Valley Community College,CT,889048,2015443,3515000,6419491,0,
2083900,Northern New Mexico College,NM,1051562,1957707,3402000,6411269,0,
689500,University Of Nebraska Medical Center,NE,1295673,1817776,3295000,6408449,0,
251400,North Central Missouri College,MO,892038,2004717,3509000,6405755,0,
196000,Spalding University,KY,1155755,1902707,3346000,6404462,0,
319100,Concordia University,OR,1572272,0,4831000,6403272,88859000,
2156600,Davis Technical College,UT,713275,1890758,3790000,6394033,0,
349000,Fisk University,TN,1085474,1829862,3475000,6390336,0,
193900,Newman University,KS,993846,1934708,3455000,6383554,0,
324400,Chatham University,PA,1162375,1858720,3357000,6378095,94216000,
253700,University Of Montana Western (The),MT,1164902,1891743,3310000,6366645,0,
117300,Pomona College,CA,1285644,1834733,3243000,6363377,2324594000,
168800,Illinois College,IL,1239311,1850025,3271000,6360336,129905000,
198800,Union College,KY,1308850,1956695,3080000,6345545,466372000,
203900,Colby College,ME,1244996,1803716,3275000,6323712,869927000,
383000,West Virginia Wesleyan College,WV,1242558,1847605,3232000,6322163,0,
798700,Bladen Community College,NC,861961,1987811,3465000,6314772,0,
4263400,Florida Polytechnic University,FL,1253303,1838614,3221000,6312917,0,
3035300,Southern Careers Institute,TX,6305240,0,0,6305240,0,
155500,Thomas University,GA,375530,1037983,4874000,6287513,29605000,
301000,Antioch University,OH,1107211,1813557,3363000,6283768,0,
272800,Hamilton College,NY,1189507,1837979,3254000,6281486,969362000,
186400,Iowa Lakes Community College,IA,966888,1921737,3389000,6277625,0,
3095500,Asa College,NY,6272628,0,0,6272628,0,
386900,Mount Mary University,WI,1157273,1857770,3250000,6265043,0,
291700,College Of The Albemarle,NC,909714,1936881,3411000,6257595,0,
362000,Southwestern University,TX,1213449,1828552,3214000,6256001,296413000,
345800,Augustana University,SD,1215394,1816774,3213000,6245168,0,
193000,Labette Community College,KS,812240,1961626,3471000,6244866,0,
290800,Barton College,NC,1161318,1847742,3223000,6232060,0,
304800,Heidelberg University,OH,1190956,1831777,3206000,6228733,51987000,
187900,Morningside College,IA,1147631,1832741,3232000,6212372,46271000,
677100,College For Creative Studies,MI,1136489,1841570,3228000,6206059,0,
273400,Houghton College,NY,1272224,1798688,3135000,6205912,57372000,
355400,Clarendon College,TX,885687,1913765,3388000,6187452,0,
369400,Saint Michael'S College,VT,1186800,1795756,3195000,6177556,89061000,
117900,Notre Dame De Namur University,CA,1121450,1836201,3219000,6176651,0,
317200,Oklahoma State University Institute Of Technology - Okmulgee,OK,2248014,3918800,0,6166814,0,
218100,Massachusetts Maritime Academy,MA,1242689,1739892,3177000,6159581,0,
214400,Dean College,MA,1087115,1840110,3225000,6152225,0,
346900,University Of Sioux Falls,SD,1036173,1853841,3259000,6149014,30327000,
1043800,Haskell Indian Nations University,KS,1111478,1837814,3195000,6144292,0,
1045300,Washington State Community College,OH,926232,1892309,3319000,6137541,0,
383700,Cardinal Stritch University,WI,1031055,1849327,3256000,6136382,0,
561200,Manatee Technical College,FL,1015473,1851459,3253000,6119932,0,
342700,Coker University,SC,1147692,1809360,3161000,6118052,45680000,
303900,Columbus College Of Art & Design,OH,1168931,1801090,3143000,6113021,0,
295800,Rockingham Community College,NC,933713,1876718,3288000,6098431,0,
352500,Tennessee Wesleyan University,TN,1192356,1787165,3116000,6095521,0,
884800,Warner University,FL,1078101,1829015,3185000,6092116,0,
370200,Averett University,VA,1055659,1828557,3200000,6084216,21268000,
466100,Hampshire College,MA,1199199,1776110,3105000,6080309,0,
137900,Connecticut College,CT,1202711,1753472,3114000,6070183,313510000,
186800,Grinnell College,IA,1190471,1761684,3107000,6059155,2069953000,
177100,Trinity Christian College,IL,1067149,1812382,3176000,6055531,0,
291800,Davidson College,NC,1220411,1743286,3090000,6053697,881465000,
476500,Cuny Graduate School & University Center,NY,776134,1877959,3393000,6047093,0,
183800,Taylor University,IN,1073311,1793326,3178000,6044637,98717000,
118700,College Of The Siskiyous,CA,785260,1909035,3349000,6043295,0,
191800,Friends University,KS,1018077,1814055,3211000,6043132,53324000,
3428300,Klamath Community College,OR,699314,1932447,3391000,6022761,0,
191300,Dodge City Community College,KS,949264,1820945,3251000,6021209,0,
298800,Bismarck State College,ND,914066,1834237,3249000,5997303,0,
2348200,Arkansas State University Mid-South,AR,855413,1869661,3266000,5991074,0,
229500,Montcalm Community College,MI,861963,1861770,3259000,5982733,0,
125800,Pacific Union College,CA,1138223,1763069,3080000,5981292,0,
337000,Swarthmore College,PA,1200865,1729865,3049000,5979730,2131553000,
369800,Vermont Technical College,VT,971406,1813509,3186000,5970915,0,
154200,Agnes Scott College,GA,1148230,1754874,3063000,5966104,217142000,
136100,Northeastern Junior College,CO,868359,1708469,3380000,5956828,0,
136200,Otero Junior College,CO,902921,1839224,3213000,5955145,0,
766900,Southwest Wisconsin Technical College,WI,783630,1868092,3299000,5950722,0,
288900,Union College,NY,1159940,1707070,3080000,5947010,466372000,
2241800,American Career College,CA,5944572,0,0,5944572,0,
380600,Alderson Broaddus University,WV,1126674,1753272,3057000,5936946,0,
351900,Rhodes College,TN,1205945,1694962,3027000,5927907,352206000,
209500,Saint Mary'S College Of Maryland,MD,1173755,1716025,3027000,5916780,0,
1302700,Yeshivath Viznitz,NY,1198248,1724833,2993000,5916081,0,
923600,Nashua Community College,NH,802358,1845578,3265000,5912936,0,
314100,Wilberforce University,OH,689372,1911149,3311000,5911521,0,
304900,Hiram College,OH,1033772,1774527,3099000,5907299,0,
397900,"Teachers College, Columbia University",NY,1118534,1680289,3107000,5905823,345191000,
258700,Saint Anselm College,NH,1134675,1695795,3067000,5897470,164005000,
327600,Immaculata University,PA,1006089,1763406,3125000,5894495,0,
227500,Kalamazoo College,MI,1178454,1709694,3006000,5894148,240344000,
406900,University Of Minnesota - Crookston,MN,864154,1816506,3207000,5887660,0,
234000,Carleton College,MN,1168048,1699739,3017000,5884787,892353000,
2547600,Florida National University,FL,5884598,0,0,5884598,0,
3108500,Everglades University,FL,776027,1751606,3354000,5881633,0,
495200,University Of Texas Medical Branch At Galveston,TX,1101752,1693386,3055000,5850138,0,
3090800,Lake Erie College Of Osteopathic Medicine,PA,1233436,1615729,2987000,5836165,0,
769300,Shawnee Community College,IL,637619,1880324,3318000,5835943,0,
558500,Lively Technical College,FL,942497,1782744,3105000,5830241,0,
2460000,University Of Puerto Rico - Medical Science Campus,PR,1190264,1662218,2962000,5814482,0,
195200,Asbury University,KY,1017118,1736565,3046000,5799683,0,
123800,Mills College,CA,1135582,1693357,2965000,5793939,196404000,
145900,Strayer University,DC,5792122,0,0,5792122,0,
2110800,California College San Diego,CA,2281144,3504173,0,5785317,0,
1226300,Atlantic Technical College,FL,758163,1801531,3225000,5784694,0,
385600,Lawrence University Of Wisconsin,WI,1157627,1673315,2953000,5783942,356958000,
286300,Corning Community College - Suny Office Of Community Colleges,NY,1937448,3844791,0,5782239,0,
370700,Richard Bland College,VA,820734,1790616,3163000,5774350,0,
1265200,Onondaga Cortland Madison Boces,NY,842620,1457826,3470000,5770446,0,
199300,Henderson Community College,KY,806658,1807184,3156000,5769842,0,
109900,Hendrix College,AR,1056780,1687170,3024000,5767950,200680000,
374700,University Of Virginia'S College At Wise (The),VA,788966,1804120,3173000,5766086,0,
1186200,Northland Pioneer College,AZ,643137,1842485,3280000,5765622,0,
2340600,Humacao Community College,PR,967546,1755904,3038000,5761450,0,
183000,Rose - Hulman Institute Of Technology,IN,1191507,1644105,2924000,5759612,0,
345500,Voorhees College,SC,1124053,1695557,2934000,5753610,0,
3130500,Urban College Of Boston,MA,608706,1874227,3261000,5743933,0,
2284300,Interactive College Of Technology,GA,5735726,0,0,5735726,0,
203800,Bowdoin College,ME,1123660,1657730,2936000,5717390,1743663000,
134700,Colorado College,CO,1157391,1638010,2921000,5716401,766910000,
236900,North Central University,MN,1046302,1692123,2956000,5694425,0,
2214100,Resurrection University,IL,1061270,1685149,2942000,5688419,0,
246000,Culver-Stockton College,MO,1067399,1676752,2929000,5673151,29467000,
2503900,Warren County Community College,NJ,686371,1791312,3191000,5668683,0,
402500,Tennessee College Of Applied Technology - Knoxville,TN,822349,1739895,3106000,5668244,0,
338500,Ursinus College,PA,1149294,1637237,2880000,5666531,131213000,
2182900,Cambridge College,MA,925862,1702049,3031000,5658911,0,
393300,Western Wyoming Community College,WY,725242,1774485,3159000,5658727,0,
3250300,Cbd College,CA,959316,1713690,2983000,5656006,0,
206500,Notre Dame Of Maryland University,MD,969449,1687957,2996000,5653406,35835000,
185900,Dordt University,IA,1082435,1654086,2915000,5651521,0,
256000,Western Nebraska Community College,NE,805697,1757098,3087000,5649795,0,
2143400,Salish Kootenai College,MT,832524,1754585,3062000,5649109,0,
117600,West Hills Community College,CA,592666,1822336,3224000,5639002,0,
111600,Art Center College Of Design,CA,2168231,3469092,0,5637323,0,
125100,Otis College Of Art & Design,CA,1100507,1648794,2887000,5636301,0,
174500,Quincy University,IL,1041392,1668907,2924000,5634299,0,
2087000,Ozarka College,AR,797075,1763049,3069000,5629124,0,
1119400,Stanly Community College,NC,731366,1777412,3110000,5618778,0,
193600,Neosho County Community College,KS,806338,1742066,3070000,5618404,0,
255900,Peru State College,NE,827344,1737928,3053000,5618272,0,
224000,Bay De Noc Community College,MI,778116,1757060,3079000,5614176,0,
931400,Great Falls College Montana State University,MT,845222,1730333,3027000,5602555,0,
3097000,Mercy College Of Ohio,OH,886791,1716262,2996000,5599053,0,
349500,Johnson University,TN,997716,1667345,2918000,5583061,0,
2196300,Collins Career Technical Center,OH,1024753,1439028,3117000,5580781,0,
268500,Cazenovia College,NY,1008776,1661084,2903000,5572860,0,
352800,Union University,TN,1984881,3240309,334000,5559190,0,
1226000,East Arkansas Community College,AR,840222,1724373,2992000,5556595,0,
375300,Virginia Military Institute,VA,1132691,1565705,2853000,5551396,0,
2301100,Turtle Mountain Community College,ND,947936,1682904,2920000,5550840,0,
808100,Carteret Community College,NC,774946,1556031,3218000,5548977,0,
168400,Greenville University,IL,957351,1667764,2919000,5544115,21160000,
177200,Trinity International University,IL,903509,1670121,2966000,5539630,0,
139800,Northwestern Connecticut Community College,CT,602265,1431434,3501000,5534699,0,
157800,Lagrange College,GA,1074446,1622319,2835000,5531765,53005000,
353400,University Of The South (The),TN,1094094,1598238,2836000,5528332,0,
327900,Juniata College,PA,1082356,1605406,2830000,5517762,120223000,
4038300,Ata College,KY,2684973,0,2830000,5514973,120223000,
961800,Tulsa Welding School,OK,5505774,0,0,5505774,0,
223700,Alpena Community College,MI,759853,1717931,3019000,5496784,0,
330200,Mount Aloysius College,PA,816503,1686780,2984000,5487283,43986000,
488200,Oregon Health & Science University,OR,1012193,1597982,2872000,5482175,0,
345700,Wofford College,SC,1103905,1561734,2802000,5467639,211673000,
254000,College Of Saint Mary,NE,1055309,1602125,2810000,5467434,0,
383500,Beloit College,WI,1086370,1588329,2790000,5464699,114121000,
524500,University Of Arkansas Community College At Morrilton,AR,1861056,3589050,0,5450106,0,
778200,Tennessee College Of Applied Technology - Dickson,TN,821613,1517962,3104000,5443575,0,
255700,Mid-Plains Community College,NE,774946,1687412,2978000,5440358,0,
122000,Master'S University And Seminary (The),CA,936440,1616925,2885000,5438365,0,
554400,Alexandria Technical And Community College,MN,807310,1669171,2957000,5433481,0,
295300,William Peace University,NC,1006338,1612358,2812000,5430696,50222000,
2305300,Parker University,TX,970426,1604204,2842000,5416630,0,
920400,Kiamichi Technology Center,OK,1023214,1570953,2817000,5411167,0,
974800,Carrington College,CA,5403151,0,0,5403151,0,
257900,New England College,NH,1554133,3460812,378000,5392945,14646000,
180100,Hanover College,IN,1065765,1569890,2748000,5383655,146078000,
179800,Franklin College Of Indiana,IN,1071874,1562660,2743000,5377534,0,
905400,West Virginia Northern Community College,WV,732317,1686844,2952000,5371161,0,
1287500,Pickens Technical College,CO,839917,1623436,2905000,5368353,0,
190900,Cloud County Community College,KS,763297,1667878,2937000,5368175,0,
111900,Barstow Community College,CA,1556808,3808377,0,5365185,0,
350400,Martin Methodist College,TN,963462,1603235,2794000,5360697,0,
172500,Monmouth College,IL,1069404,1561080,2729000,5359484,122619000,
373300,Randolph - Macon College,VA,1058238,1556549,2743000,5357787,0,
260300,Drew University,NJ,1727427,2639701,988000,5355128,183108000,
299600,North Dakota State College Of Science,ND,823352,1641417,2889000,5353769,0,
109400,University Of The Ozarks,AR,1011314,1582461,2759000,5352775,115068000,
142900,Goldey-Beacom College,DE,1040019,1561354,2747000,5348373,0,
253300,Montana State University - Northern,MT,911258,1614369,2820000,5345627,0,
211700,Anna Maria College,MA,911801,1619045,2809000,5339846,0,
2170700,Brunswick Community College,NC,795340,1651117,2893000,5339457,0,
3493300,All-State Career,MD,5309772,0,0,5309772,0,
246400,Fontbonne University,MO,986867,1567916,2750000,5304783,0,
101200,Birmingham-Southern College,AL,1069855,1533280,2696000,5299135,0,
3193300,Manhattan School Of Computer Technology,NY,801874,1639673,2838000,5279547,0,
357500,Howard Payne University,TX,1041913,1536043,2687000,5264956,62865000,
180300,Huntington University,IN,960261,1561180,2741000,5262441,0,
317400,Oklahoma Panhandle State University,OK,882583,1591219,2781000,5254802,0,
293000,Greensboro College,NC,962182,1553970,2717000,5233152,0,
3129100,Fond Du Lac Tribal & Community College,MN,744831,1624762,2862000,5231593,0,
304600,Franklin University,OH,846988,2889785,1492000,5228773,93156000,
206700,Washington Adventist University,MD,805558,1602392,2813000,5220950,0,
286100,Cayuga Community College - Suny Office Of Community College,NY,1497604,3718340,0,5215944,0,
4115500,Talmudical Seminary Of Bobov,NY,949733,1467438,2798000,5215171,0,
316700,University Of Science & Arts Of Oklahoma,OK,1020519,1529512,2662000,5212031,0,
296000,Salem College,NC,1007410,1532126,2669000,5208536,0,
3105200,Baptist Health College Little Rock,AR,876349,1410310,2918000,5204659,0,
329800,Messiah College,PA,2106740,3089265,0,5196005,141904000,
344500,Presbyterian College,SC,1038216,1506419,2650000,5194635,91533000,
342200,Southern Wesleyan University,SC,841417,1583800,2768000,5193217,0,
717100,Kirtland Community College,MI,712739,1629004,2842000,5183743,0,
2346500,Ogden-Weber Technical College,UT,596044,1595765,2991000,5182809,0,
694200,Mid-America Christian University,OK,716752,1622104,2832000,5170856,0,
190400,Bethany College,KS,1005488,1511010,2632000,5148498,0,
381100,Davis & Elkins College,WV,980322,1518906,2646000,5145228,0,
484500,Wilson Community College,NC,718656,1606406,2819000,5144062,0,
2482700,Western University Of Health Sciences,CA,1105699,1417353,2620000,5143052,0,
258600,Rivier University,NH,902722,1529331,2703000,5135053,41389000,
4134100,Jersey College,NJ,5119863,0,0,5119863,0,
323700,Bryn Mawr College,PA,1022842,1472661,2623000,5118503,907976000,
160400,Young Harris College,GA,1019320,1486015,2609000,5114335,0,
283200,Saint Thomas Aquinas College,NY,489023,1662920,2953000,5104943,0,
267100,Bard College,NY,2064786,2969456,70000,5104242,0,
339200,Westminster College,PA,1265227,1876014,1942000,5083241,116515000,
110900,University Of Arkansas For Medical Sciences,AR,972976,1458213,2622000,5053189,0,
197500,Midway University,KY,892872,1614558,2535000,5042430,0,
3113300,Uei College,CA,5025381,0,0,5025381,0,
196400,Georgetown College,KY,934826,1481847,2605000,5021673,0,
256300,Union College,NE,757995,1167914,3080000,5005909,466372000,
376800,Washington And Lee University,VA,1045044,1418018,2539000,5002062,1676308000,
855800,Beaufort County Community College,NC,695419,1563932,2742000,5001351,0,
293900,Lees-Mcrae College,NC,925656,1485773,2587000,4998429,0,
252500,William Woods University,MO,894737,1476897,2620000,4991634,0,
3960300,New River Community And Technical College,WV,688982,1567267,2731000,4987249,0,
822800,Seward County Community College,KS,734560,1535377,2712000,4981937,0,
526000,J. F. Drake State Community And Technical College,AL,761763,1539687,2679000,4980450,0,
118300,Holy Names University,CA,895448,1475062,2577000,4947510,54171000,
773800,Southern Arkansas University Tech,AR,782909,1507722,2645000,4935631,0,
3413300,Mountainland Technical College,UT,609482,1545193,2778000,4932675,0,
2115300,Pinellas Technical College - St. Petersburg Campus,FL,621026,1536181,2766000,4923207,0,
2136600,Wisconsin Lutheran College,WI,925999,1448476,2543000,4917475,36629000,
196100,Centre College Of Kentucky,KY,986773,1421366,2509000,4917139,0,
150800,North Florida College,FL,715483,1528120,2673000,4916603,0,
108700,Arkansas Baptist College,AR,831019,1482487,2597000,4910506,0,
113400,California State University Maritime Academy,CA,977757,1381700,2550000,4909457,0,
330900,Peirce College,PA,611389,1562718,2722000,4896107,23557000,
345400,University Of South Carolina - Salkehatchie,SC,783241,1496153,2608000,4887394,0,
276300,Maria College,NY,697463,1370774,2809000,4877237,0,
346600,Northern State University,SD,659777,1518172,2699000,4876949,0,
370800,Eastern Mennonite University,VA,893425,1442117,2540000,4875542,0,
2155300,Chicago School Of Professional Psychology,CA,756112,1860461,2256000,4872573,0,
531100,Tulsa Technology Center School District No. 18,OK,1717200,3155311,0,4872511,0,
129100,Simpson University,CA,892430,1445294,2518000,4855724,0,
158700,Paine College,GA,798094,1484462,2571000,4853556,0,
672500,University Of Tennessee Health Science Center,TN,998078,1363552,2491000,4852630,0,
3294300,Blue Cliff College,LA,4843075,0,0,4843075,0,
776400,Southeast Technical Institute,SD,1770458,3069293,0,4839751,0,
203600,Bates College,ME,953516,1395754,2487000,4836270,329723000,
156300,Emmanuel College,GA,871449,1442139,2519000,4832588,151725000,
1073600,Marion Technical College,OH,953875,2068897,1803000,4825772,0,
196900,Kentucky Wesleyan College,KY,843204,1448016,2523000,4814220,0,
4221300,Philadelphia Technician Training Institute,PA,675783,1503388,2626000,4805171,0,
239300,Minnesota State College Southeast,MN,666447,1499186,2636000,4801633,0,
253400,Rocky Mountain College,MT,933392,1401924,2455000,4790316,32055000,
3969600,Uei College,CA,4785647,0,0,4785647,0,
4127300,Columbia College,VA,609412,0,4172000,4781412,168869000,
235500,Hibbing Community College,MN,779596,1451871,2540000,4771467,0,
322500,Warner Pacific University,OR,778206,1451123,2538000,4767329,0,
768700,James Sprunt Community College,NC,661318,1375164,2728000,4764482,0,
164300,Spoon River College,IL,617648,1506166,2639000,4762814,0,
859700,Feather River College,CA,599153,1495117,2666000,4760270,0,
205200,Thomas College,ME,762266,1438966,2540000,4741232,19614000,
994100,Belmont College,OH,773450,1444467,2523000,4740917,0,
163900,Blackburn University,IL,913064,1398751,2428000,4739815,0,
184600,Briar Cliff University,IA,853293,1407399,2467000,4727692,0,
337600,Thiel College,PA,931754,1380896,2406000,4718650,0,
1072700,Devry University,IL,4713768,0,0,4713768,0,
530900,Lake Area Technical Institute,SD,1768161,2943424,0,4711585,0,
179300,Earlham College,IN,958680,1361707,2391000,4711387,418845000,
252600,Carroll College,MT,941622,1361291,2401000,4703913,44828000,
228800,Rochester University,MI,787257,1424071,2486000,4697328,0,
388400,Ripon College,WI,908784,1364469,2422000,4695253,94328000,
192400,Independence Community College,KS,746807,1432021,2500000,4678828,0,
281300,Sarah Lawrence College,NY,944456,1338169,2391000,4673625,117046000,
760200,Northeastern Technical College,SC,544363,1504443,2624000,4672806,0,
986300,Pennsylvania College Of Health Sciences,PA,778640,1405978,2472000,4656618,0,
235600,Itasca Community College,MN,741976,1421466,2493000,4656442,0,
3941300,Ave Maria University,FL,927779,1339857,2377000,4644636,0,
279500,Paul Smith'S College Of Arts & Sciences,NY,922258,1357184,2364000,4643442,0,
1077900,Porter And Chester Institute,CT,4642939,0,0,4642939,0,
306500,Kenyon College,OH,940498,1315552,2382000,4638050,422019000,
198700,Transylvania University,KY,878886,1278124,2472000,4629010,191238000,
109300,Central Baptist College,AR,822986,1385745,2412000,4620731,0,
954900,Western Texas College,TX,556115,1449094,2614000,4619209,0,
2077100,Milwaukee Institute Of Art & Design,WI,840652,1374550,2395000,4610202,0,
271800,Elmira College,NY,917861,1340299,2344000,4602160,0,
4208600,Relay Graduate School Of Education,NY,740441,1355661,2506000,4602102,0,
288500,Albany College Of Pharmacy And Health Sciences,NY,941221,1299052,2360000,4600273,0,
739400,Berkeley College,NY,4596874,0,0,4596874,0,
133900,Corban University,OR,887403,1343986,2364000,4595389,0,
134100,Westmont College,CA,950992,1311893,2316000,4578885,78908000,
3652300,Metropolitan Learning Institute,NY,660220,1394537,2521000,4575757,0,
1047400,Marymount California University,CA,874466,1342246,2345000,4561712,0,
2501500,Orange Technical College - Mid Florida Campus,FL,538345,1444270,2573000,4555615,0,
4138100,Yeshiva Of Machzikai Hadas,NY,895153,1337216,2318000,4550369,0,
315600,Redlands Community College,OK,608459,1427978,2511000,4547437,0,
185600,Cornell College,IA,845562,1330085,2367000,4542647,76288000,
3021900,Edic College,PR,4538123,0,0,4538123,0,
315100,Oklahoma Wesleyan University,OK,797766,1361300,2379000,4538066,0,
478800,Herkimer County Community College - Suny Office Of Community Colleges,NY,1522074,3009187,0,4531261,0,
757000,Helena College University Of Montana,MT,685627,1394148,2451000,4530775,0,
1122000,Windward Community College,HI,551098,1432714,2539000,4522812,0,
307300,Marietta College,OH,870471,1322182,2330000,4522653,88469000,
4161800,Brandman University,CA,1196618,3322586,0,4519204,0,
3122900,York County Community College,ME,556529,1436695,2521000,4514224,0,
314600,Western Oklahoma State College,OK,635791,1409851,2463000,4508642,0,
627300,Mercy College Of Health Sciences,IA,805957,1345841,2347000,4498798,0,
281000,Sage Colleges,NY,1712646,2784805,0,4497451,38937000,
335100,Cairn University,PA,771522,1343540,2364000,4479062,0,
299000,University Of Jamestown,ND,848958,1316400,2310000,4475358,0,
361900,Southwestern Adventist University,TX,801162,1339319,2334000,4474481,0,
289600,Villa Maria College Of Buffalo,NY,807056,1340693,2325000,4472749,0,
187500,Marshalltown Community College,IA,636628,1384816,2445000,4466444,0,
750200,Berkeley College,NJ,4464258,0,0,4464258,0,
192900,Kansas Wesleyan University,KS,823462,1320499,2303000,4446961,0,
701200,Samuel Merritt University,CA,841525,1284267,2310000,4435792,51316000,
175700,Southeastern Illinois College,IL,460547,1429347,2537000,4426894,0,
4065300,Roseman University Of Health Sciences,NV,893841,1213666,2307000,4414507,0,
398100,University Of North Carolina School Of The Arts,NC,868886,1268365,2259000,4396251,0,
202300,University Of Holy Cross,LA,708685,1338263,2348000,4394948,0,
546100,Salem Community College,NJ,665129,1352495,2372000,4389624,0,
204400,Maine Maritime Academy,ME,876568,1263932,2248000,4388500,0,
188300,Northwestern College,IA,822778,1291574,2273000,4387352,0,
3106200,Franciscan Missionaries Of Our Lady University,LA,721431,1324432,2338000,4383863,0,
306600,Lake Erie College,OH,803405,1292618,2272000,4368023,0,
381600,Southern West Virginia Community And Technical College,WV,1523218,2843370,0,4366588,0,
204100,University Of Maine - Fort Kent,ME,626037,1353803,2386000,4365840,0,
808300,Haywood Community College,NC,614386,1361522,2385000,4360908,0,
622800,Methodist College,IL,736004,1319115,2298000,4353119,22069000,
553500,Pine Technical And Community College,MN,481263,1397218,2470000,4348481,0,
273500,Hilbert College,NY,683112,1329533,2331000,4343645,0,
342600,University Of South Carolina - Sumter,SC,705800,1321358,2316000,4343158,0,
195100,Alice Lloyd College,KY,754640,1309966,2277000,4341606,0,
291100,Bennett College,NC,768798,1301805,2264000,4334603,0,
327400,Haverford College,PA,873803,1246052,2210000,4329855,529487000,
4143200,Hult International Business School,MA,882754,1209495,2224000,4316249,0,
850400,Richland College,TX,4316107,0,0,4316107,0,
247300,Kansas City Art Institute,MO,840665,1262617,2199000,4302282,0,
236500,Minneapolis College Of Art & Design,MN,807630,1268917,2217000,4293547,0,
1205000,Rosedale Technical College,PA,842493,1252706,2192000,4287199,0,
2341000,Fortis College,AL,4282458,0,0,4282458,0,
795000,West Shore Community College,MI,564751,1225927,2491000,4281678,0,
383100,Wheeling University,WV,766653,1274648,2240000,4281301,0,
576000,Northern Maine Community College,ME,655429,1320610,2304000,4280039,0,
321700,Reed College,OR,842657,1237124,2197000,4276781,579820000,
205100,Saint Joseph'S College,ME,649094,1306280,2315000,4270374,0,
1100900,Palau Community College,PW,759490,1283232,2225000,4267722,0,
3079800,George T. Baker Aviation Technical College,FL,624978,1323182,2316000,4264160,0,
215100,Benjamin Franklin Institute Of Technology,MA,814858,1256813,2190000,4261671,0,
728900,Central Wyoming College,WY,578937,1328069,2347000,4254006,0,
179900,Goshen College,IN,792911,1257733,2203000,4253644,113643000,
125200,Hope International University,CA,681856,1229636,2335000,4246492,0,
313400,Ursuline College,OH,673311,1294301,2275000,4242612,0,
632400,Laboure College,MA,661421,1298168,2268000,4227589,0,
370300,Bluefield College,VA,691152,1286307,2247000,4224459,0,
203300,University Of Maine - Presque Isle,ME,610998,1310251,2302000,4223249,0,
345300,University Of South Carolina - Lancaster,SC,570863,1322097,2324000,4216960,0,
117000,Claremont Mckenna College,CA,855579,1204979,2133000,4193558,865475000,
239800,Blue Mountain College,MS,784621,1241220,2162000,4187841,0,
161700,College Of Idaho (The),ID,809015,1222831,2146000,4177846,0,
3957400,New College Of Florida,FL,837170,1196735,2143000,4176905,0,
380800,Bethany College,WV,582649,962066,2632000,4176715,0,
193300,Mcpherson College,KS,795375,1229981,2150000,4175356,47125000,
291200,Brevard College,NC,782339,1235952,2155000,4173291,28160000,
186200,Ellsworth Community College,IA,715943,1253256,2188000,4157199,0,
348400,Covenant College,GA,822751,1203174,2116000,4141925,42681000,
297900,Warren Wilson College,NC,776538,1224969,2140000,4141507,51270000,
371500,Hollins University,VA,799714,1184387,2152000,4136101,182729000,
991000,Technical College Of The Lowcountry - Beaufort Campus,SC,1283989,2850584,0,4134573,0,
932200,Williamsburg Technical College,SC,589306,1235202,2307000,4131508,0,
697700,Great Basin College,NV,470059,1323265,2338000,4131324,0,
214500,Eastern Nazarene College,MA,761413,1225868,2143000,4130281,0,
226400,Gogebic Community College,MI,661272,1259603,2201000,4121875,0,
1286000,Arkansas Northeastern College,AR,566883,1289032,2262000,4117915,0,
400900,Mesabi Range College,MN,561010,1289340,2263000,4113350,0,
184400,Wabash College,IN,810923,1197190,2098000,4106113,344252000,
294800,Montreat College,NC,735993,1225163,2142000,4103156,0,
223900,Aquinas College,MI,1204512,1910297,984000,4098809,0,
131900,"University Of California, San Francisco",CA,867955,1133080,2095000,4096035,0,
343800,Medical University Of South Carolina,SC,937694,1114732,2042000,4094426,375593000,
469200,Dorsey School Of Business,MI,4088414,0,0,4088414,0,
569900,George Corley Wallace State Community College - Selma,AL,1298325,2786974,0,4085299,0,
161400,Kauai Community College,HI,535684,1285285,2259000,4079969,0,
343600,Limestone College,SC,1350503,2699581,0,4050084,0,
908900,Hannibal - Lagrange University,MO,759488,1196420,2091000,4046908,0,
798600,Halifax Community College,NC,616040,1241708,2175000,4032748,0,
4131700,Southwest University At El Paso,TX,4026674,0,0,4026674,0,
711300,Arizona Christian University,AZ,747009,1188662,2074000,4009671,0,
183500,Saint Mary Of The Woods College,IN,637917,1227989,2143000,4008906,0,
215000,Fisher College,MA,496691,1265283,2245000,4006974,97743000,
398200,Cleveland Institute Of Art (The),OH,801788,1162031,2026000,3989819,0,
226300,Glen Oaks Community College,MI,576681,1232639,2167000,3976320,0,
241400,Millsaps College,MS,761840,1161398,2050000,3973238,0,
3422300,Milan Institute,TX,3963075,0,0,3963075,0,
1290700,Lake Tahoe Community College,CA,348926,1290394,2322000,3961320,0,
185200,Clarke University,IA,768683,1155469,2032000,3956152,29340000,
351100,Milligan College,TN,742753,1160607,2050000,3953360,0,
342900,Columbia International University,SC,676941,1183116,2080000,3940057,0,
226500,Grace Christian University,MI,485111,1257228,2189000,3931339,0,
1099800,Pennsylvania Institute Of Technology,PA,518726,1247621,2164000,3930347,0,
301600,Bluffton University,OH,768698,1144619,2001000,3914317,0,
187100,Iowa Wesleyan University,IA,699320,1171539,2042000,3912859,0,
2524000,Sunstate Academy,FL,814778,1435284,1656000,3906062,0,
380300,Whitman College,WA,764766,1128146,2009000,3901912,565256000,
190200,Cowley County Community College & Area Vocational Technical School,KS,1206714,2692584,0,3899298,0,
915900,Paul D. Camp Community College,VA,512617,1227213,2154000,3893830,0,
2569400,Escuela De Artes Plasticas Y Diseño De Puerto Rico,PR,686208,1170824,2034000,3891032,0,
861400,Rabbinical College Bobover Yeshiva Bnei Zion,NY,751000,1148403,1988000,3887403,0,
257200,Colby-Sawyer College,NH,779605,1128568,1977000,3885173,39449000,
1194000,Instituto Comercial De Puerto Rico Junior College,PR,3879773,0,0,3879773,0,
3003600,William T Mcfatter Technical College,FL,603976,1180478,2083000,3867454,0,
560800,Traviss Technical College,FL,644793,1173090,2038000,3855883,0,
535400,Tennessee College Of Applied Technology-Jackson,TN,510365,1124050,2208000,3842415,0,
4142600,Touro University,CA,797347,1069020,1975000,3841367,0,
2100600,Carrington College,AZ,3823185,0,0,3823185,0,
194500,Sterling College,KS,662915,1151312,2008000,3822227,0,
252300,Westminster College,MO,768643,1111314,1942000,3821957,116515000,
335200,Philadelphia College Of Osteopathic Medicine,PA,863192,1038054,1919000,3820246,417899000,
367200,Lds Business College,UT,1422523,2392206,0,3814729,0,
560500,Pinellas Technical College - Clearwater Campus,FL,527113,1190438,2095000,3812551,0,
298900,Dickinson State University,ND,640093,1148421,2024000,3812514,0,
336000,Rosemont College,PA,653142,1142284,2004000,3799426,0,
753100,Academy Of Art University,CA,3791776,0,0,3791776,0,
1230000,Palmer College Of Chiropractic,IA,809390,1049646,1932000,3791036,58825000,
477600,Central Yeshiva Tomchei Tmimim Lubavitz,NY,743134,1111506,1934000,3788640,0,
195800,Brescia University,KY,504094,1196232,2086000,3786326,0,
365900,University Of Texas Health Science Center At San Antonio,TX,1545801,2223504,0,3769305,0,
538400,Nicolet Area Technical College,WI,484116,1192563,2092000,3768679,0,
4037300,Los Angeles Film School (The),CA,3766527,0,0,3766527,0,
3346300,Academy For Nursing And Health Occupations,FL,541389,1174616,2040000,3756005,0,
755800,Fort Myers Technical College,FL,507574,1134896,2113000,3755470,0,
2228300,Lake Technical College,FL,568563,1157066,2027000,3752629,0,
1119700,Mayland Community College,NC,588968,1146354,2014000,3749322,0,
2168600,East-West University,IL,638436,1135709,1965000,3739145,0,
331700,Cheyney University Of Pennsylvania,PA,663615,1044814,2030000,3738429,0,
2600900,Aveda Arts & Sciences Institute Covington,LA,3712040,0,0,3712040,0,
194000,Southwestern College,KS,490411,1166646,2044000,3701057,0,
329400,Manor College,PA,790389,1541671,1363000,3695060,0,
108800,Lyon College,AR,680216,1096447,1913000,3689663,0,
211800,Assumption College,MA,1485031,2203031,0,3688062,102942000,
123600,Menlo College,CA,744390,1064287,1864000,3672677,0,
2189100,Cem College,PR,3669368,0,0,3669368,0,
319800,Linfield College,OR,1441325,2218297,0,3659622,108080000,
529100,White Mountains Community College,NH,488503,1152186,2017000,3657689,0,
346100,Dakota Wesleyan University,SD,641844,1094081,1918000,3653925,0,
851000,Eastfield College,TX,3649693,0,0,3649693,0,
2330500,Laguna College Of Art And Design,CA,661479,1081100,1892000,3634579,0,
3661400,South Florida Institute Of Technology,FL,3625271,0,0,3625271,0,
238900,University Of Minnesota - Morris,MN,1434554,2163039,0,3597593,0,
808500,Mcdowell Technical Community College,NC,527975,1113327,1953000,3594302,0,
393100,Northwest College,WY,732668,1311889,1548000,3592557,38942000,
3127900,Osceola Technical College,FL,590003,1094090,1908000,3592093,0,
558600,Lindsey Hopkins Technical College,FL,501691,1119239,1967000,3587930,0,
2222700,Francis Tuttle Technology Center School District No. 21,OK,1347306,2237088,0,3584394,0,
493800,South College,TN,3576321,0,0,3576321,0,
159700,Truett Mcconnell University,GA,489215,1105771,1971000,3565986,0,
573200,University Of Arkansas Community College At Hope-Texarkana,AR,1156335,2407209,0,3563544,0,
2117500,Naropa University,CO,656811,1053383,1853000,3563194,0,
4206400,Helms College,GA,602995,1077607,1869000,3549602,0,
980000,Rush University,IL,683762,1008068,1845000,3536830,620253000,
1287200,North-West College,CA,3525534,0,0,3525534,0,
2098300,Western Technical College,TX,3503977,0,,3503977,0,
3480300,Fortis College,LA,3493748,0,0,3493748,0,
2242900,United Tribes Technical College,ND,339952,1151040,1995000,3485992,0,
648900,Christ College Of Nursing And Health Sciences,OH,567902,1060598,1852000,3480500,0,
304100,Defiance College,OH,662680,1026944,1790000,3479624,19129000,
4169800,Gurnick Academy Of Medical Arts,CA,3477356,0,0,3477356,0,
3071900,Mount Carmel College Of Nursing,OH,605611,1029901,1837000,3472512,0,
135500,Lamar Community College,CO,588420,1049005,1835000,3472425,0,
535300,Tennessee College Of Applied Technology-Livingston,TN,479769,1082755,1905000,3467524,0,
139300,Mitchell College,CT,616528,1036072,1814000,3466600,0,
193800,Pratt Community College,KS,518364,1065589,1876000,3459953,0,
251200,Stephens College,MO,668976,1014615,1771000,3454591,0,
402600,Tennessee College Of Applied Technology - Crossville,TN,499909,1069622,1884000,3453531,0,
252400,William Jewell College,MO,707592,989524,1739000,3436116,0,
318900,Clatsop Community College,OR,444841,1078746,1911000,3434587,0,
159600,Toccoa Falls College,GA,481239,1067910,1880000,3429149,0,
356800,Frank Phillips College,TX,488436,1065020,1871000,3424456,0,
371300,Hampden Sydney College,VA,679908,988698,1749000,3417606,0,
160000,Wesleyan College,GA,587801,1027993,1801000,3416794,0,
638900,Goldfarb School Of Nursing At Barnes-Jewish College,MO,669542,989079,1745000,3403621,0,
290100,Wells College,NY,623035,1014898,1765000,3402933,0,
190100,Allen County Community College,KS,416499,1076217,1909000,3401716,0,
941200,Fortis College,OH,3398488,0,0,3398488,0,
2270600,Life Pacific University,CA,606084,1017845,1772000,3395929,0,
191100,Colby Community College,KS,469448,1052247,1863000,3384695,0,
2511000,Southwestern Indian Polytechnic Institute,NM,593278,1017848,1770000,3381126,0,
3103900,Marion Technical College,FL,541724,1034079,1803000,3378803,0,
112700,California College Of The Arts,CA,1397586,1980370,0,3377956,36040000,
528300,Tennessee College Of Applied Technology - Newbern,TN,571359,961675,1839000,3372034,0,
373400,Randolph College,VA,664874,984559,1721000,3370433,0,
2052700,Northeast Technology Center,OK,456375,1037246,1867000,3360621,0,
387500,Northland College,WI,636542,992151,1731000,3359693,0,
943000,Tri-County Community College,NC,522349,1026395,1797000,3345744,0,
2115400,Bridgerland Technical College,UT,411631,1053906,1874000,3339537,0,
755500,Lakes Region Community College,NH,439512,1044695,1848000,3332207,0,
3062700,Platt College,CA,3330094,0,0,3330094,0,
2117100,Art Institute Of Houston (The),TX,3313919,0,0,3313919,0,
1236200,Northwestern College,IL,1029287,0,2273000,3302287,0,
125900,Palo Verde College,CA,349166,1038714,1910000,3297880,0,
3666300,Pillar College,NJ,562480,996324,1736000,3294804,0,
531000,Pittsburgh Institute Of Aeronautics,PA,458946,1013613,1780000,3252559,0,
3010800,Fortis Institute,AL,3246774,0,0,3246774,0,
1082600,Tom P. Haney Technical Center,FL,539960,988396,1717000,3245356,0,
167800,Eureka College,IL,624909,947882,1654000,3226791,0,
330600,University Of Valley Forge,PA,599907,955627,1670000,3225534,0,
1050300,Wichita Technical Institute,KS,3213488,0,0,3213488,0,
148500,College Of The Florida Keys (The),FL,481856,989069,1740000,3210925,0,
267000,Clarks Summit University,PA,596633,942626,1666000,3205259,0,
182400,Oakland City University,IN,465821,981448,1744000,3191269,0,
460000,Northwest Iowa Community College,IA,422535,996810,1771000,3190345,0,
492700,University Of South Carolina - Union,SC,457913,986521,1740000,3184434,0,
927000,Art Institute Of Atlanta (The),GA,3179031,0,0,3179031,0,
2260500,Summit Academy Opportunities Industrialization Center,MN,1272165,1905539,0,3177704,0,
2511700,Ridge Technical College,FL,516450,970771,1690000,3177221,0,
254800,Hastings College,NE,1051950,1452549,665000,3169499,0,
3067500,Institute Of Technology,CA,3164257,0,,3164257,,
1231500,Cornish College Of The Arts,WA,632813,915631,1613000,3161444,0,
106500,University Of Alaska Southeast,AK,372939,1001982,1784000,3158921,0,
117200,Pitzer College,CA,625861,913259,1619000,3158120,144365000,
2297700,Automeca Technical College,PR,3157261,0,0,3157261,0,
3971300,American Career College,CA,3157248,0,0,3157248,0,
4169700,Unitek College,CA,3157044,0,0,3157044,0,
353600,Bryan College,TN,579257,1199750,1377000,3156007,0,
499600,Dabney S Lancaster Community College,VA,444563,981191,1725000,3150754,0,
236100,Martin Luther College,MN,531043,945500,1670000,3146543,0,
238300,Crown College,MN,491090,960841,1686000,3137931,0,
560700,Suncoast Technical College,FL,425821,971627,1739000,3136448,0,
2183000,Orleans Technical College,PA,582950,931256,1620000,3134206,0,
248500,Midwestern Baptist Theological Seminary,MO,466997,948700,1713000,3128697,0,
2068200,Cox College,MO,492010,955693,1678000,3125703,0,
2073500,University Of Arkansas Community College At Batesville,AR,1029926,2093350,0,3123276,0,
4074300,Hondros College Of Nursing,OH,3120827,0,0,3120827,0,
2106600,American Institute,CT,3113907,0,0,3113907,0,
537900,Tennessee College Of Applied Technology-Shelbyville,TN,547306,931766,1631000,3110072,0,
1001400,Garrett College,MD,504992,947671,1655000,3107663,0,
2599400,New York College Of Health Professions,NY,537043,930830,1629000,3096873,0,
171600,Maccormac College,IL,382008,992573,1720000,3094581,0,
2190700,Fortis College,OH,3093935,0,0,3093935,0,
287900,Sullivan County Community College - Suny Office Of Community Colleges,NY,1038982,2053779,0,3092761,0,
2326900,Sunstate Academy,FL,478081,947773,1656000,3081854,0,
200300,Centenary College Of Louisiana,LA,608956,890394,1579000,3078350,0,
998100,Morgan Community College,CO,411258,966838,1698000,3076096,0,
3532400,Ata College,CA,246006,0,2830000,3076006,120223000,
155700,Brewton Parker College,GA,449184,950942,1665000,3065126,0,
196500,Kentucky Christian University,KY,531102,919413,1605000,3055515,0,
756000,River Valley Community College,NH,384684,965201,1705000,3054885,0,
174600,Robert Morris University Illinois,IL,3052761,0,0,3052761,0,
343200,Erskine College,SC,587364,894189,1570000,3051553,0,
392900,Eastern Wyoming College,WY,420524,945262,1685000,3050786,0,
121700,Lassen College,CA,335004,963037,1733000,3031041,0,
526500,North Central Kansas Technical College,KS,490545,917405,1613000,3020950,0,
996200,Luna Community College,NM,399419,948067,1673000,3020486,0,
2114200,Johnson College,PA,559569,897027,1561000,3017596,0,
183400,Calumet College Of Saint Joseph,IN,562456,886885,1554000,3003341,0,
1302200,City University Of Seattle,WA,432868,918942,1651000,3002810,0,
368200,Bennington College,VT,592763,869044,1534000,2995807,0,
1323400,Lorenzo Walker Technical College,FL,492820,858353,1634000,2985173,0,
2099700,Ross Medical Education Center,MI,2973094,0,0,2973094,0,
1258900,Erie 1 Board Of Cooperative Educational Services,NY,577270,868446,1524000,2969716,0,
2307400,George Stone Technical College,FL,446933,916920,1605000,2968853,0,
4151900,Columbia Gorge Community College,OR,375638,938681,1654000,2968319,0,
1081900,Conservatorio De Música De Puerto Rico,PR,548486,878541,1531000,2958027,0,
110400,Phillips Community College Of The University Of Arkansas,AR,905327,2043633,0,2948960,0,
318000,Southwestern Christian University,OK,534184,879278,1528000,2941462,0,
194600,Tabor College,KS,525581,874230,1530000,2929811,0,
120500,Golden Gate University,CA,464148,871390,1580000,2915538,46828000,
919200,Sierra Nevada College,NV,553670,852648,1508000,2914318,0,
2556700,Seminar L'Moros Bais Yaakov,NY,644413,829572,1439000,2912985,0,
247700,A. T. Still University Of Health Sciences,MO,539820,831012,1536000,2906832,0,
461900,Sullivan University,KY,2903218,0,0,2903218,0,
850300,Mountain View College,TX,2902459,0,0,2902459,0,
165900,Rosalind Franklin University Of Medicine And Science,IL,600592,807025,1492000,2899617,0,
3830300,Sae Institute Of Technology,TN,2892306,0,0,2892306,0,
135900,Colorado Northwestern Community College,CO,397997,898356,1593000,2889353,0,
2202700,Ozark Christian College,MO,489464,871809,1521000,2882273,0,
1185900,Word Of Life Bible Institute,NY,506756,858197,1503000,2867953,0,
300800,Valley City State University,ND,452941,868060,1532000,2853001,0,
3612400,Valley Grande Institute For Academic Studies,TX,422034,885308,1535000,2842342,0,
110600,Williams Baptist University,AR,528721,839882,1465000,2833603,0,
190800,Central Christian College Of Kansas,KS,464984,861626,1506000,2832610,0,
526700,Northwest Kansas Technical College,KS,479285,841008,1493000,2813293,0,
569200,Reid State Technical College,AL,435328,866379,1508000,2809707,0,
565500,Hacienda La Puente Adult Education,CA,388304,853390,1559000,2800694,0,
2558700,Prism Career Institute,PA,2799781,0,0,2799781,0,
533900,Metro Technology Centers School District #22,OK,466807,836177,1491000,2793984,0,
703500,Kettering College,OH,525294,817668,1451000,2793962,0,
746800,School Of Visual Arts,NY,2793698,0,0,2793698,0,
2310800,Lancaster County Career And Technology Center,PA,508099,824731,1454000,2786830,0,
2316200,Miami Lakes Educational Center And Technical College,FL,362478,866414,1556000,2784892,0,
320700,Pacific Northwest College Of Art,OR,456256,779482,1548000,2783738,0,
2219500,Mildred Elley,NY,2777967,0,0,2777967,0,
1201100,Talmudical Seminary Oholei Torah,NY,538150,818735,1420000,2776885,0,
3358300,Allen School,NY,2769386,0,0,2769386,0,
2180000,Northwest Indian College,WA,403967,862256,1503000,2769223,0,
887800,Miami International University Of Art & Design,FL,2762168,0,0,2762168,0,
296300,Southeastern Baptist Theological Seminary,NC,347269,847381,1567000,2761650,0,
122900,Southern California University Of Health Sciences,CA,401546,832703,1518000,2752249,0,
235000,Vermilion Community College,MN,454539,830732,1460000,2745271,0,
2128300,Institute For Business & Technology,CA,2735892,0,0,2735892,0,
673100,Casa Loma College,CA,506509,739820,1488000,2734329,0,
117400,Scripps College,CA,546083,785174,1401000,2732257,375585000,
4206500,Mycomputercareer.Com,NC,2727181,0,0,2727181,0,
3523300,Aviation Institute Of Maintenance,GA,2722482,0,0,2722482,0,
3709300,Edward Via Virginia College Of Osteopathic Medicine,VA,589803,747735,1382000,2719538,0,
2202500,New England Tractor Trailer Training School Of Connecticut,CT,2717490,0,0,2717490,0,
3002500,J.F. Ingram State Technical College,AL,448264,822536,1443000,2713800,0,
194300,University Of Saint Mary,KS,976950,1603725,118000,2698675,0,
2143700,Sinte Gleska University,SD,385959,838117,1466000,2690076,0,
2541200,Stratford University,VA,2689835,0,0,2689835,0,
1015300,Helene Fuld College Of Nursing,NY,445514,816859,1426000,2688373,0,
746500,American Academy Of Dramatic Arts,NY,533811,778823,1367000,2679634,0,
346700,Presentation College,SD,454681,807234,1410000,2671915,0,
678900,Columbia - Greene Community College - Suny Office Of Cmnty Colleges,NY,840707,1827663,0,2668370,0,
986200,Clarkson College,NE,441901,806294,1419000,2667195,0,
190500,Bethel College,KS,531372,777483,1358000,2666855,0,
220100,Pine Manor College,MA,518912,782334,1363000,2664246,0,
289200,United States Merchant Marine Academy,NY,569967,708815,1381000,2659782,0,
233700,Bethany Lutheran College,MN,471985,789349,1390000,2651334,44117000,
178400,Ancilla Domini College,IN,492118,784978,1366000,2643096,0,
376200,Virginia University Of Lynchburg,VA,357917,835545,1449000,2642462,0,
639900,Bryan College Of Health Sciences,NE,484417,780709,1377000,2642126,0,
526400,Flint Hills Technical College,KS,306504,829141,1487000,2622645,0,
2321200,Orange Technical College - Westside Campus,FL,293856,834853,1490000,2618709,0,
2317200,Maranatha Baptist University,WI,410308,792518,1394000,2596826,0,
3230300,Okaloosa Technical College And Choice High School,FL,393330,792866,1410000,2596196,0,
125500,Pacific Oaks College,CA,340238,815692,1434000,2589930,0,
535100,Tennessee College Of Applied Technology - Morristown,TN,877779,1711569,0,2589348,0,
536300,Denmark Technical College,SC,412522,787267,1376000,2575789,0,
996800,Gordon Cooper Technology Center,OK,509679,746137,1319000,2574816,0,
757300,Empire Beauty School,NY,2572614,0,0,2572614,0,
260000,College Of Saint Elizabeth,NJ,935846,1630679,0,2566525,0,
102600,Marion Military Institute,AL,514237,742268,1307000,2563505,0,
550000,Manhattan Area Technical College,KS,369841,790612,1399000,2559453,0,
117100,Harvey Mudd College,CA,516332,733506,1303000,2552838,328568000,
342100,Bob Jones University,SC,2552058,0,0,2552058,0,
445300,El Centro College,TX,2550619,,0,2550619,0,
1017000,Western Dakota Technical Institute,SD,863880,1673430,0,2537310,0,
3101300,Granite State College,NH,269441,819990,1438000,2527431,0,
274200,Juilliard School (The),NY,524199,712263,1289000,2525462,0,
1167300,Maine College Of Art,ME,507454,734222,1283000,2524676,0,
2533600,Ross Medical Education Center,MI,2521578,0,0,2521578,0,
746900,Hussian College,PA,2519530,0,0,2519530,0,
209300,Saint John'S College,NM,377298,544087,1594000,2515385,0,
2300900,Withlacoochee Technical College,FL,403755,769396,1340000,2513151,0,
2331300,Interactive College Of Technology,TX,2503478,0,0,2503478,0,
232200,Finlandia University,MI,447690,748336,1304000,2500026,0,
2077400,North Lake College,TX,2498181,0,0,2498181,0,
121200,Humphreys University,CA,398142,764036,1335000,2497178,0,
2220900,Cossatot Community College Of The University Of Arkansas,AR,775262,1715171,0,2490433,0,
752600,Florida Panhandle Technical College,FL,378062,768153,1340000,2486215,0,
300700,Williston State College,ND,338809,772089,1360000,2470898,0,
320600,Multnomah University,OR,433018,738474,1294000,2465492,0,
2231600,Mgh Institute Of Health Professions,MA,500795,687131,1271000,2458926,0,
2237900,Tennessee College Of Applied Technology-Paris,TN,394967,752114,1310000,2457081,0,
3789300,Unitech Training Academy,LA,2453939,0,0,2453939,0,
2132300,Fortis Institute,NJ,2435661,0,0,2435661,0,
148200,Florida College,FL,445256,722456,1264000,2431712,0,
528100,Tennessee College Of Applied Technology - Elizabethton,TN,881164,1549711,0,2430875,0,
256700,York College,NE,459315,716808,1251000,2427123,0,
374800,Eastern Shore Community College,VA,338336,754006,1320000,2412342,0,
2140800,Martin University,IN,395736,735403,1277000,2408139,0,
2339700,Ross Medical Education Center,MI,2390068,0,0,2390068,0,
1254400,St. Johns County School District,FL,308355,585637,1495000,2388992,0,
726400,Mesivta Torah Vodaath Rabbinical Seminary,NY,459637,663172,1263000,2385809,0,
3838500,Northwest Career College,NV,2384152,0,0,2384152,0,
113200,California Institute Of The Arts,CA,1014886,1365215,0,2380101,178839000,
1203100,San Diego Christian College,CA,421905,711004,1244000,2376909,0,
950900,Charles A. Jones Career And Education Center,CA,365709,733656,1275000,2374365,0,
2248200,Milan Institute Of Cosmetology,NV,2373948,0,0,2373948,0,
3129200,Rabbinical College Of Ohr Shimon Yisroel,NY,460264,694125,1219000,2373389,0,
3101900,Trinity Baptist College,FL,421907,712214,1239000,2373121,0,
2143500,Sterling College,VT,129712,228347,2008000,2366059,0,
3108100,Summit College,CA,2365247,0,0,2365247,0,
828400,Mitchell Technical Institute,SD,879422,1485562,0,2364984,0,
2342700,Fortis College,VA,2359780,0,0,2359780,0,
2263700,Miami Valley Career Technology Center,OH,244731,685943,1428000,2358674,0,
224600,Cleary University,MI,384753,714577,1253000,2352330,0,
726300,Holy Cross College,IN,469591,682060,1193000,2344651,0,
2060300,Miat College Of Technology,MI,2341441,0,0,2341441,0,
1054200,Empire Beauty School,PA,2339199,0,0,2339199,0,
299300,Mayville State University,ND,312720,733724,1290000,2336444,0,
2510600,Blackfeet Community College,MT,266062,753694,1311000,2330756,0,
252700,University Of Providence,MT,376995,705742,1245000,2327737,0,
890200,Columbia Central University,PR,2321653,0,0,2321653,0,
1099300,Hobart Institute Of Welding Technology,OH,485886,663262,1164000,2313148,0,
678700,Clinton Community College - Suny Office Of Community Colleges,NY,765962,1545848,0,2311810,0,
1005300,"Indian Capital Technology Center, School District Number 4",OK,885933,1404206,0,2290139,0,
2531800,Paul Mitchell The School Costa Mesa,CA,2289751,0,0,2289751,0,
275900,Manhattan School Of Music,NY,441481,655621,1189000,2286102,0,
3422400,College Of Biblical Studies-Houston,TX,203755,833405,1245000,2282160,0,
661200,Covenant School Of Nursing And Allied Health,TX,403823,681520,1194000,2279343,0,
330000,Moore College Of Art And Design,PA,441674,669083,1167000,2277757,0,
3590400,Ntma Training Centers Of Southern California,CA,427969,672688,1170000,2270657,0,
2079400,Empire Beauty School,PA,2268234,0,0,2268234,0,
528000,Tennessee College Of Applied Technology - Covington,TN,248249,524530,1495000,2267779,0,
265000,University Of The Southwest,NM,435854,663788,1166000,2265642,0,
2504600,Orange Technical College-Winter Park Campus,FL,265697,711621,1286000,2263318,0,
2260800,Huertas College,PR,2262464,0,0,2262464,0,
861300,Roanoke Chowan Community College,NC,353481,691315,1208000,2252796,0,
299100,Lake Region State College,ND,110878,371642,1768000,2250520,0,
1032600,Tennessee College Of Applied Technology - Harriman,TN,411299,663406,1174000,2248705,0,
1111300,Maharishi International University,IA,408145,657539,1182000,2247684,0,
494900,Baylor College Of Medicine,TX,506003,610941,1129000,2245944,1301005000,
192000,Hesston College,KS,444466,654430,1143000,2241896,0,
2584400,New England Tractor Trailer Training School Of Massachusetts,RI,2226771,0,0,2226771,0,
2073700,Northwest Technical Institute,AR,437217,651865,1134000,2223082,0,
817800,Empire Beauty School,MI,2219238,0,0,2219238,0,
2188200,Sitting Bull College,ND,375048,669488,1164000,2208536,0,
2173200,Empire Beauty School,NY,2208217,0,0,2208217,0,
2242500,Bastyr University,WA,501592,606942,1095000,2203534,0,
2495500,All-State Career School,PA,2203255,0,0,2203255,0,
923100,Washington County Community College,ME,341449,678640,1182000,2202089,0,
2361500,Michigan Barber School,MI,447200,611486,1139000,2197686,0,
2354200,Scioto County Career Technical Center,OH,419892,649101,1125000,2193993,0,
3181400,Merkaz Bnos,NY,403827,633910,1156000,2193737,0,
1014700,Western Suffolk Boces,NY,422592,644964,1126000,2193556,0,
2100200,Brookhaven College,TX,2187307,0,0,2187307,0,
946400,Tennessee College Of Applied Technology-Pulaski,TN,263555,661864,1258000,2183419,0,
4146300,Fred K. Marchman Technical College,FL,320269,673867,1179000,2173136,0,
331100,Salus University,PA,503656,586171,1083000,2172827,48896000,
2195800,Liceo De Arte Y Tecnología,PR,2168379,0,0,2168379,0,
492300,Clinton College,SC,233942,707265,1224000,2165207,0,
2180100,Ross Medical Education Center,MI,2164321,0,0,2164321,0,
4095300,King'S College (The),NY,396742,639724,1127000,2163466,0,
113100,California Institute Of Technology,CA,908781,1254418,0,2163199,2975376000,
2157100,Concorde Career College,TN,2155995,0,0,2155995,0,
3076100,Southwestern College,NM,45392,63334,2044000,2152726,0,
2559400,Intercoast Colleges,CA,2149757,0,0,2149757,0,
528200,Tennessee College Of Applied Technology-Hartsville,TN,318610,659236,1164000,2141846,0,
3367400,Community Care College,OK,2135245,0,0,2135245,0,
997600,College Of The Ouachitas,AR,669324,1457805,0,2127129,0,
3158300,Cape Coral Technical College,FL,358183,635804,1127000,2120987,0,
1085800,Avalon School Of Cosmetology,AZ,2120430,0,0,2120430,0,
338600,Valley Forge Military College,PA,385652,600069,1126000,2111721,0,
102300,Judson College,AL,369009,632686,1100000,2101695,0,
2278800,Southern Technical College,FL,2097167,0,0,2097167,0,
4177100,Pima Medical Institute,CO,2092022,0,0,2092022,0,
265600,New Mexico Military Institute,NM,415633,606810,1062000,2084443,0,
247400,Kansas City University Of Medicine And Biosciences,MO,409399,587192,1085000,2081591,0,
1070000,Tennessee College Of Applied Technology-Jacksboro,TN,365951,614625,1090000,2070576,0,
191400,Donnelly College,KS,294832,645519,1130000,2070351,0,
2334400,Centura College,VA,2069211,0,0,2069211,0,
3696400,Saber College,FL,382767,539191,1147000,2068958,0,
381900,Ohio Valley University,WV,405760,577221,1076000,2058981,0,
3570500,Northpoint Bible College,MA,423110,596720,1039000,2058830,0,
314700,Bacone College,OK,509457,565617,983000,2058074,0,
154500,Andrew College,GA,355871,617316,1073000,2046187,0,
2513200,Orange Technical College - Orlando Campus,FL,255268,642991,1143000,2041259,0,
2063000,Montserrat College Of Art,MA,375198,605741,1057000,2037939,0,
3115900,Trinity College Of Puerto Rico,PR,394678,599261,1038000,2031939,0,
2338500,Glendale Career College,CA,2025197,0,0,2025197,0,
1262700,Thomas M. Cooley Law School,MI,405235,566834,1048000,2020069,0,
185500,Des Moines University - Osteopathic Medical Center,IA,422290,557988,1032000,2012278,0,
1260600,Empire Beauty School,PA,2008780,0,0,2008780,0,
3373300,Beacon College,FL,405430,582246,1018000,2005676,0,
1167000,Yeshiva Of Nitra Rabbinical College,NY,386639,589386,1022000,1998025,0,
966400,Empire Beauty School,PA,1988069,0,0,1988069,0,
1242500,Stone Academy,CT,1976921,0,0,1976921,0,
1229300,Veeb Nassau County School Of Practical Nursing,NY,391740,578090,1003000,1972830,0,
2523700,Ocean County Vocational - Technical Schools,NJ,380824,578987,1010000,1969811,0,
2246300,Ross Medical Education Center,OH,1965598,0,0,1965598,0,
170800,Lincoln Christian University,IL,332245,592346,1041000,1965591,0,
4149700,Homestead Schools,CA,309756,605232,1050000,1964988,0,
2453500,Medical College Of Wisconsin,WI,386216,552026,1020000,1958242,937909000,
3751300,Escuela Hotelera De San Juan,PR,1955007,0,0,1955007,0,
2192100,Butler Technology And Career Development Schools,OH,292763,602897,1057000,1952660,0,
3035900,National Aviation Academy,FL,1950415,0,0,1950415,0,
1071000,Capital Area Career Center,IL,371962,571192,989000,1932154,0,
1111200,Fashion Institute Of Design & Merchandising,CA,1931729,0,0,1931729,0,
2065300,Prescott College,AZ,301297,589575,1036000,1926872,0,
1235800,Plaza College,NY,1926657,0,0,1926657,0,
945900,Empire Beauty School,ME,1925983,0,0,1925983,0,
1232800,Northwestern Health Sciences University,MN,388538,543636,989000,1921174,0,
2175800,Centra College,VA,229579,610634,1070000,1910213,0,
1036500,Charles R. Drew University Of Medicine And Science,CA,360477,554830,988000,1903307,0,
357900,Jacksonville College,TX,283804,585060,1034000,1902864,0,
575900,Northwest Technical College - Bemidji,MN,192242,618678,1088000,1898920,0,
2330300,Lebanon County Career And Technology Center,PA,336929,504439,1053000,1894368,0,
2146000,Wayne - Finger Lakes Boces,NY,362846,560471,971000,1894317,0,
2218800,Brookline College,AZ,1890270,0,0,1890270,0,
299500,Dakota College At Bottineau,ND,234429,599989,1055000,1889418,0,
4121700,Dixie Technical College,UT,202805,571074,1113000,1886879,0,
751800,Apex Technical School,NY,1885989,0,0,1885989,0,
535700,Tennessee College Of Applied Technology Crump,TN,274881,559948,1051000,1885829,0,
752500,Riveroak Technical College,FL,269159,532525,1082000,1883684,0,
3531300,Universidad Pentecostal Mizpa,PR,301648,577248,1002000,1880896,0,
271000,Cooper Union For The Advancement Of Science & Art (The),NY,766505,1110434,0,1876939,0,
486600,Stautzenberger College,OH,1866592,0,0,1866592,0,
2358000,Thomas Aquinas College,CA,354873,519039,984000,1857912,0,
2179400,Eastern Suffolk Boces,NY,273593,524450,1056000,1854043,0,
3076300,Beulah Heights University,GA,295126,565763,992000,1852889,0,
3206300,Mesalands Community College,NM,198978,593738,1060000,1852716,0,
2140000,Riverside College Of Health Careers,VA,346191,546629,956000,1848820,0,
648700,Aultman College Of Nursing And Health Sciences,OH,295724,563861,983000,1842585,0,
2117300,Great Oaks Career Campuses-Scarlet Oaks,OH,332099,528952,979000,1840051,0,
1216400,Tennessee College Of Applied Technology Ripley,TN,226994,470019,1140000,1837013,0,
657700,Upmc Shadyside,PA,345358,542395,949000,1836753,0,
3885300,Employment Solutions,KY,275569,483506,1074000,1833075,0,
3068600,Special School District Of St. Louis County,MO,333269,534788,961000,1829057,0,
3411400,International Training Careers,FL,397293,522735,904000,1824028,0,
3426300,College Of Health Care Professions (The),TX,1823842,0,0,1823842,0,
219400,New England Conservatory Of Music,MA,367317,520449,934000,1821766,0,
2093700,Long Island Business Institute,NY,1821234,0,0,1821234,0,
3639300,West Coast Ultrasound Institute,CA,1805882,0,0,1805882,0,
624000,Saint Francis Medical Center College Of Nursing,IL,318356,538606,946000,1802962,0,
356200,Dallas Theological Seminary,TX,306745,523837,969000,1799582,0,
322800,Bryn Athyn College Of The New Church,PA,348922,527749,922000,1798671,0,
1320800,Baptist Bible College,MO,360668,568398,869000,1798066,0,
2127400,Yti Career Institute,PA,1793845,0,0,1793845,0,
4131100,Yeshiva Toras Chaim,NJ,347751,527203,917000,1791954,0,
1302600,Machzikei Hadath Rabbinical College,NY,346953,528178,915000,1790131,0,
1168900,Refrigeration School (The),AZ,1786314,0,0,1786314,0,
116900,Claremont Graduate University,CA,295107,522077,966000,1783184,186766000,
649400,Good Samaritan College Of Nursing And Health Science,OH,270661,550028,961000,1781689,0,
278400,New York Medical College,NY,374257,493127,912000,1779384,83043000,
860900,Rabbinical College Of America,NJ,347256,520890,911000,1779146,0,
3903500,Southern Technical College,FL,1776085,0,0,1776085,0,
245800,Cottey College,MO,334857,525514,915000,1775371,110200000,
3814400,Soka University Of America,CA,351126,511076,912000,1774202,0,
2103500,Tennessee College Of Applied Technology - Murfreesboro,TN,607231,1165386,0,1772617,0,
4224300,Valor Christian College,OH,294534,546901,927000,1768435,0,
2610900,Stone Child College,MT,216798,547688,1000000,1764486,0,
2192200,Thomas Edison State University,NJ,17249,633035,1113000,1763284,0,
143600,Capitol Technology University,MD,288665,531807,936000,1756472,0,
1077100,Gupton-Jones College Of Funeral Service,GA,275886,538259,933000,1747145,0,
535200,Tennessee College Of Applied Technology-Mckenzie,TN,321987,495548,927000,1744535,0,
252800,Miles Community College,MT,246778,541465,953000,1741243,0,
4118800,New York Film Academy,CA,1739271,0,0,1739271,0,
2562300,Apollo Career Center,OH,168199,544541,1026000,1738740,0,
4193700,John Paul The Great Catholic University,CA,343805,506092,886000,1735897,0,
2335500,Theological University Of The Caribbean,PR,281192,525906,919000,1726098,0,
1054900,Kehilath Yakov Rabbinical Seminary,NY,334422,507413,884000,1725835,0,
3424500,New Community Career And Technical Institute,NJ,289766,475626,956000,1721392,0,
1086000,Greater Altoona Career & Technology Center,PA,291116,520740,906000,1717856,0,
3000100,Yeshiva Gedolah Imrei Yosef D'Spinka,NY,326856,508501,880000,1715357,0,
535800,Tennessee College Of Applied Technology - Athens,TN,246105,531907,937000,1715012,0,
4255700,Bolivar Technical College,MO,240473,537712,935000,1713185,0,
2111100,University Of Arkansas Community College Rich Mountain,AR,542149,1170671,0,1712820,0,
120000,Fuller Theological Seminary,CA,293342,497198,919000,1709540,0,
549900,Salina Area Technical College,KS,203959,539924,964000,1707883,0,
1033800,Eastern Virginia Medical School,VA,329653,482539,892000,1704192,107959000,
2068100,Adler University,IL,260680,502259,929000,1691939,0,
368600,Goddard College,VT,320334,497499,874000,1691833,0,
3123900,Southeastern College,FL,1689659,0,0,1689659,0,
2618400,Michigan Career And Technical Institute,MI,238067,526316,921000,1685383,0,
1088000,Chatfield College,OH,260540,519257,903000,1682797,0,
974700,Gordon Conwell Theological Seminary,MA,267766,495574,917000,1680340,0,
2309500,Clovis Adult Education,CA,166012,435456,1074000,1675468,0,
3066600,Bay Mills Community College,MI,222497,528866,922000,1673363,0,
2163300,Universidad Central Del Caribe,PR,305084,494244,872000,1671328,0,
887100,Concorde Career College,CO,1667137,0,0,1667137,0,
712100,Faith Baptist Bible College & Theological Seminary,IA,297034,496725,869000,1662759,0,
4119000,Eastern West Virginia Community & Technical College,WV,211888,524164,918000,1654052,0,
3069100,Allen College,IA,282895,490373,871000,1644268,0,
754900,Coyne College,IL,1641135,0,0,1641135,0,
2506000,Associated Beth Rivkah Schools,NY,284824,495633,859000,1639457,0,
3015300,Ehove Career Center,OH,228724,513389,896000,1638113,0,
3572300,East Valley Institute Of Technology,AZ,236123,503990,897000,1637113,0,
4146200,Emerald Coast Technical College,FL,305110,484527,847000,1636637,0,
2272700,Columbiana County Vocational School District,OH,242978,506736,878000,1627714,0,
3516300,King'S University (The),TX,274750,490625,862000,1627375,0,
3104200,Carolinas College Of Health Sciences,NC,268630,489746,864000,1622376,0,
2297000,Charlotte Technical College,FL,248791,489765,883000,1621556,0,
740100,Mandl School,NY,1620451,0,0,1620451,0,
2075800,Southern California Institute Of Architecture (The),CA,339620,458145,822000,1619765,0,
4194900,Tillamook Bay Community College,OR,315778,472016,831000,1618794,0,
3427500,University Of Antelope Valley,CA,1613796,0,0,1613796,0,
2555400,University Of Texas Md Anderson Cancer Center,TX,285840,478904,844000,1608744,0,
1138500,College Of The Atlantic,ME,303385,473835,830000,1607220,0,
4178000,Simmons College Of Kentucky,KY,240805,499431,866000,1606236,0,
2542300,National Holistic Institute,CA,1602448,0,0,1602448,0,
2505800,Yeshiva Karlin Stolin,NY,306121,462864,830000,1598985,0,
702600,Icahn School Of Medicine At Mount Sinai,NY,336074,442990,819000,1598064,0,
1173200,Mayo Clinic College Of Medicine And Science,MN,328294,446290,821000,1595584,0,
2073400,Carver Career And Technical Education Center,WV,307983,470190,816000,1594173,0,
2159600,Baptist College Of Florida (The),FL,262085,483725,846000,1591810,0,
964500,Bard College At Simon'S Rock,MA,312339,463190,815000,1590529,0,
2092800,Tennessee College Of Applied Technology Whiteville,TN,203162,461879,925000,1590041,0,
250400,St. Louis College Of Pharmacy,MO,678296,908540,0,1586836,144776000,
2601600,Brewster Technical College,FL,179902,507564,898000,1585466,0,
283900,State University Of New York Downstate Medical Center,NY,658028,927377,0,1585405,0,
2343600,Institute Of Beauty Careers,PR,1583438,0,0,1583438,0,
1014800,Colorado Technical University,CO,1581179,0,0,1581179,0,
2286600,Little Big Horn College,MT,260189,479458,839000,1578647,0,
3784400,Tohono O'Odham Community College,AZ,199279,508878,870000,1578157,0,
2583000,Gwinnett College,GA,1577669,0,,1577669,0,
656500,Reading Hospital School Of Health Sciences,PA,269244,475342,833000,1577586,0,
1000600,Greater Johnstown Area Vocational Technical School,PA,255046,481436,837000,1573482,0,
640400,Nebraska Methodist College Of Nursing & Allied Health,NE,557892,1011693,0,1569585,0,
396600,Boston Architectural College,MA,279755,460236,819000,1558991,11822000,
4117100,E.D.P. School,NY,259277,475810,823000,1558087,0,
4162500,Hollywood Institute Of Beauty Careers,FL,1554527,0,0,1554527,0,
633100,Lawrence Memorial Hospital School Of Nursing,MA,238782,478023,837000,1553805,0,
2328900,Emmaus Bible College,IA,313744,451587,787000,1552331,0,
975600,University Of Massachusetts Medical School,MA,310132,435006,804000,1549138,0,
2138300,Palo Alto University,CA,303711,438443,796000,1538154,0,
2536600,Commonwealth Technical Institute,PA,268150,460825,807000,1535975,0,
3113600,Southern California Institute Of Technology,CA,1535401,0,0,1535401,0,
647700,Cabarrus College Of Health Sciences,NC,253120,462682,812000,1527802,0,
813200,Toledo Public Schools Adult And Continuing Education,OH,219334,471735,832000,1523069,0,
976800,University Of North Texas Health Science Center At Fort Worth,TX,687698,832399,0,1520097,0,
2361600,Concorde Career College,MO,1519727,0,0,1519727,0,
2282500,Lenape Technical School,PA,267853,457121,793000,1517974,0,
372600,American National University,VA,1508237,0,0,1508237,0,
374200,Sweet Briar College,VA,272489,448436,786000,1506925,0,
1092300,Union Institute & University,OH,187502,476989,836000,1500491,0,
1026600,Randall University,OK,250159,455448,793000,1498607,0,
3006300,Ibmc College,CO,1497661,0,0,1497661,0,
1162100,Automotive Training Center,PA,1497626,0,0,1497626,0,
394800,San Francisco Art Institute,CA,283166,438533,773000,1494699,0,
2236500,Cankdeska Cikana (Little Hoop) Community College,ND,216968,466352,810000,1493320,0,
3029600,Pomona Adult School,CA,245993,453341,787000,1486334,0,
106100,Alaska Pacific University,AK,254627,445957,784000,1484584,0,
2230500,Ogle School Hair Skin Nails,TX,1482600,0,0,1482600,0,
1182100,Yeshivath Zichron Moshe,NY,287275,435215,759000,1481490,0,
3695300,Community Enhancement Services,CA,267036,443325,768000,1478361,0,
346500,Mount Marty College,SD,489509,986775,0,1476284,0,
996500,Canadian Valley Technology Center School District No. 6,OK,601347,872268,0,1473615,0,
4228100,High Desert Medical College,CA,1472341,0,0,1472341,0,
4227800,Bethany Global University,MN,261065,438908,767000,1466973,0,
2117400,Beck School Of Practical Nursing,IL,274401,402122,782000,1458523,0,
2548800,South Texas Vocational Technical Institute,TX,1455120,0,0,1455120,0,
195300,Asbury Theological Seminary,KY,260367,419058,775000,1454425,150440000,
301100,Art Academy Of Cincinnati,OH,247921,440321,766000,1454242,0,
405700,National American University,SD,1453446,0,0,1453446,0,
2269900,Pennsylvania College Of Art & Design,PA,275900,427928,746000,1449828,0,
1001900,University Of Texas Southwestern Medical Center (The),TX,602606,843650,0,1446256,0,
267700,Brooklyn Law School,NY,251110,417427,772000,1440537,0,
3125100,College Of Menominee Nation,WI,174970,461052,802000,1438022,0,
703100,Pamlico Community College,NC,222221,440805,774000,1437026,0,
3001800,Welch College,TN,230280,437532,767000,1434812,0,
1300500,Olympian Academy Of Cosmetology,NM,1430238,0,0,1430238,0,
2336300,Knox County Career Center,OH,168704,457494,801000,1427198,0,
470300,Logan University,MO,224284,425016,772000,1421300,0,
4153800,Bethel College,VA,19542,42577,1358000,1420119,0,
140100,Post University,CT,1419702,0,0,1419702,0,
1116500,Uintah Basin Technical College,UT,167365,441354,810000,1418719,0,
4259700,University Of Saint Katherine,CA,246937,426935,742000,1415872,0,
663900,Bellin College,WI,219481,429279,766000,1414760,0,
998700,Saint Anthony College Of Nursing,IL,245511,422976,740000,1408487,0,
1170700,North-West College,CA,1406776,0,0,1406776,0,
109500,Crowley'S Ridge College,AR,265023,415315,722000,1402338,0,
3797400,Career Care Institute,CA,1401625,0,0,1401625,0,
356100,Cedar Valley College,TX,1401492,0,0,1401492,0,
3889300,Stanbridge University,CA,1395629,0,0,1395629,0,
2554200,Radford M. Locklin Technical College,FL,177103,438306,774000,1389409,0,
2166200,Iti Technical College,LA,1381165,0,0,1381165,0,
4179500,North American University,TX,244712,410312,726000,1381024,0,
4224900,College Of The Muscogee Nation,OK,239337,414665,723000,1377002,0,
2560700,Pickaway Ross County Joint Vocational School District,OH,243181,411338,722000,1376519,0,
2304700,Tri-Rivers Career Center,OH,247988,411141,715000,1374129,0,
3068200,Ohio Media School,OH,1374115,0,0,1374115,0,
2330100,Pioneer Pacific College,OR,1373074,0,0,1373074,0,
1248300,Paul Mitchell The School Dallas,TX,1367452,0,0,1367452,0,
2524200,Robert Morgan Educational Center And Technical College,FL,447181,917050,0,1364231,0,
2337700,Professional Skills Institute,OH,1362751,0,0,1362751,0,
2172800,Dutchess Boces School Of Practical Nursing,NY,229402,381112,748000,1358514,0,
2352800,Polaris Career Center - Adult Education Department,OH,231446,409778,713000,1354224,0,
4271200,Seminary Bnos Chaim,NJ,255559,399256,693000,1347815,0,
2351500,Northern Career Institute,OH,176450,428465,742000,1346915,0,
812900,Adult And Community Education @Hudson,OH,284038,388440,674000,1346478,0,
798800,Martin Community College,NC,217290,408657,719000,1344947,0,
2266400,Central Christian College Of The Bible,MO,242288,401542,698000,1341830,0,
1179900,Paul Mitchell The School Fayetteville,NC,1340711,0,0,1340711,0,
2089600,Concorde Career Institute,FL,1340456,0,0,1340456,0,
278300,New York Law School,NY,271478,374306,692000,1337784,0,
448400,John F. Kennedy University,CA,196815,404291,736000,1337106,0,
1155300,William R Moore College Of Technology,TN,180060,418831,735000,1333891,0,
2272400,Eastern College Of Health Vocations,AR,1332068,0,0,1332068,0,
3096400,Leech Lake Tribal College,MN,219804,404474,702000,1326278,0,
767800,Spartan College Of Aeronautics And Technology,OK,1326190,0,0,1326190,0,
553200,Cape Girardeau Career And Technology Center,MO,206430,407135,711000,1324565,0,
245000,Calvary University,MO,216452,402803,705000,1324255,0,
2588200,Douglas J Aveda Institute,MI,1324125,0,0,1324125,0,
173200,National University Of Health Sciences (The),IL,290635,364355,666000,1320990,0,
520800,College Of Westchester (The),NY,1320712,0,0,1320712,0,
754400,Appalachian Bible College,WV,238981,391112,684000,1314093,0,
2280900,Mid-Atlantic Christian University,NC,242130,390579,681000,1313709,0,
2073300,Gallia Jackson Vinton Joint School Adult Education,OH,226505,397080,690000,1313585,0,
407100,Walsh College Of Accountancy & Business Administration,MI,422403,888354,0,1310757,9730000,
4208400,Riverside County Office Of Education,CA,186455,400908,718000,1305363,0,
3084700,Ventura Adult And Continuing Education,CA,207297,399893,697000,1304190,0,
3115300,Genesee-Livingston-Steuben-Wyoming Boces,NY,262134,377237,662000,1301371,0,
394700,"University Of California, Hastings College Of The Law",CA,276618,359671,665000,1301289,0,
2357700,Paul Mitchell The School Houston,TX,1300078,0,0,1300078,0,
746600,Lim College,NY,1293881,0,0,1293881,0,
3019800,Pci Health Training Center,TX,1276232,0,0,1276232,0,
497700,South Texas College Of Law Houston,TX,263331,353441,653000,1269772,0,
2454400,Northeast Ohio Medical University,OH,272933,349668,646000,1268601,0,
284000,State University Of New York Upstate Medical University,NY,519926,748378,0,1268304,0,
4191500,Tooele Technical College,UT,115803,378812,770000,1264615,0,
646100,Saint Elizabeth Medical Center,NY,220241,379861,660000,1260102,0,
4054300,Southwest Technical College,UT,137095,400716,721000,1258811,0,
2532600,Landmark College,VT,210858,378549,669000,1258407,0,
2527500,Houston Training Schools,TX,1254446,0,0,1254446,0,
209200,St. John'S College,MD,398355,571777,280000,1250132,217294000,
1301600,Ogle School Hair Skin Nails,TX,1248354,0,0,1248354,0,
3028200,Trinity College Of Florida,FL,194883,383451,666000,1244334,0,
2320900,Tidewater Tech,VA,1243306,0,0,1243306,0,
397800,Rabbinical Seminary Of America,NY,258526,350073,634000,1242599,0,
3452300,Colegio Educativo Tecnológico Industrial,PR,276174,354111,612000,1242285,0,
697500,Lincoln University,CA,310107,331212,600000,1241319,0,
127800,San Francisco Conservatory Of Music,CA,249016,348163,642000,1239179,43146000,
2160100,Geneva General Hospital,NY,237274,361172,633000,1231446,0,
295600,Piedmont International University,NC,407862,823035,0,1230897,0,
2090700,Cleveland University-Kansas City,KS,223811,363417,642000,1229228,0,
1076200,Western Technology Center School District No. 12,OK,240715,357148,631000,1228863,0,
3071600,College Of Business & Technology,FL,1227280,0,0,1227280,0,
191700,Barclay College,KS,214618,368996,643000,1226614,0,
2096100,Fielding Graduate University,CA,231198,349312,646000,1226510,0,
3856300,Universal Career School,FL,1214724,0,0,1214724,0,
3542300,Concorde Career College,TX,1209817,0,0,1209817,0,
4265900,Yeshiva Kollel Tifereth Elizer,NY,241572,353452,611000,1206024,0,
3106500,Sentara College Of Health Sciences,VA,178560,371502,652000,1202062,0,
4057300,Asher College,CA,1201948,0,0,1201948,0,
3198400,Mid-Del Technology Center,OK,135205,380123,678000,1193328,0,
2538300,Delta College Of Arts & Technology,LA,1192751,0,0,1192751,0,
3434300,Fortis College,FL,1192474,0,0,1192474,0,
208700,Ner Israel Rabbinical College,MD,229867,342629,611000,1183496,0,
3100800,Big Bend Technical College,FL,198157,357947,625000,1181104,0,
536500,York County School Of Technology,PA,205192,350014,620000,1175206,0,
3066900,Intellitec College,CO,1174578,0,0,1174578,0,
2206000,Hunter Business School,NY,1168966,0,0,1168966,0,
4265300,Yeshiva Gedolah Keren Hatorah,NJ,229239,342779,596000,1168018,0,
1240700,Schuyler Steuben Chemung Tioga Allegany Boces,NY,108927,246401,804000,1159328,0,
1076100,Dallas Institute Of Funeral Service,TX,220704,341830,596000,1158534,0,
621400,Blessing Hospital,IL,210868,342254,602000,1155122,0,
1032300,Hannah E Mullins School Of Practical Nursing,OH,164959,361994,627000,1153953,0,
642100,Jfk Medical Center Muhlenberg Harold B. And Dorothy A. Snyder Schools,NJ,417854,733771,0,1151625,0,
2113600,American Intercontinental University,AZ,1150405,0,0,1150405,0,
793600,Lincoln College Of Technology,MD,1149547,0,0,1149547,0,
3727600,Auguste Escoffier School Of Culinary Arts,TX,1148379,0,0,1148379,0,
4210400,Beth Medrash Meor Yitzchok,NY,228892,334848,584000,1147740,0,
657400,"St. Luke'S Hospital Of Bethlehem, Pa",PA,191622,346459,608000,1146081,0,
2163600,William James College,MA,232998,320587,590000,1143585,0,
1291200,Mti College,CA,1142459,0,0,1142459,0,
1227200,Moore Norman Technology Center School District No. 17,OK,278987,862226,0,1141213,0,
1120600,Pioneer Technology Center,OK,262829,316361,561000,1140190,0,
542900,Rolla Technical Institute Center,MO,210305,307498,620000,1137803,0,
2101000,Northwest College School Of Beauty,OR,1136700,0,0,1136700,0,
1205900,Trinity Bible College And Graduate School,ND,204391,339024,593000,1136415,0,
4138600,Alaska Christian College,AK,201678,342002,592000,1135680,0,
1124500,West Virginia School Of Osteopathic Medicine,WV,247036,311772,576000,1134808,0,
3144400,American College Of Healthcare And Technology,CA,1134326,0,0,1134326,0,
535600,Tennessee College Of Applied Technology - Hohenwald,TN,261811,871170,0,1132981,0,
2253700,Intellitec College,CO,1132045,0,0,1132045,0,
4083400,Cambridge College Of Healthcare & Technology,FL,1131811,0,0,1131811,0,
3611300,Brighton Center'S Center For Employment Training,KY,92638,368508,666000,1127146,0,
2107300,Pennsylvania Academy Of The Fine Arts,PA,222164,327432,577000,1126596,0,
193100,Manhattan Christian College,KS,204954,333837,583000,1121791,0,
2582000,Bnos Zion Of Bobov Seminary,NY,215691,331316,574000,1121007,0,
2596400,Spartan College Of Aeronautics & Technology,CA,1117522,0,0,1117522,0,
3124000,Northwestern Technological Institute,MI,1108949,0,0,1108949,0,
752200,Continental School Of Beauty Culture,NY,1106191,0,0,1106191,0,
1290500,Academy Of Careers And Technology,WV,174170,328076,601000,1103246,0,
2534800,Fred W. Eberle Technical Center,WV,121970,257779,723000,1102749,0,
1236400,St. Paul'S School Of Nursing,NY,1102325,0,0,1102325,0,
288700,Albany Medical College,NY,234607,304631,563000,1102238,0,
2218000,Carrington College,ID,1101321,0,0,1101321,0,
915600,Wayne County Schools Career Center,OH,120311,302849,675000,1098160,0,
641700,Holy Name Medical Center School Of Nursing,NJ,206390,289450,593000,1088840,0,
3070500,D'Mart Institute,PR,1086083,0,0,1086083,0,
2534000,National University Of Natural Medicine,OR,217745,305236,556000,1078981,0,
3982300,Visible Music College,TN,185814,324819,566000,1076633,0,
4150800,Immokalee Technical College,FL,181354,323216,570000,1074570,0,
3008800,Brillare Beauty Institute,TN,191387,305891,577000,1074278,0,
778000,New Castle School Of Trades,PA,1073423,0,0,1073423,0,
1224800,Central School Of Practical Nursing,OH,218545,311893,541000,1071438,0,
2170200,Albany Schoharie Schenectady Saratoga Boces Practical Nursing Program,NY,416996,650370,0,1067366,0,
252900,Dawson Community College,MT,142151,332253,588000,1062404,0,
3042500,Carrington College,OR,1060396,0,0,1060396,0,
239100,Mitchell Hamline School Of Law,MN,212893,296989,549000,1058882,0,
947900,St. Paul'S School Of Nursing,NY,1056892,0,0,1056892,0,
2146400,Institute Of American Indian & Alaska Native Culture & Artsdevelopment,NM,342519,713431,0,1055950,0,
2343000,Fort Peck Community College,MT,151493,324875,579000,1055368,0,
350600,Meharry Medical College,TN,219976,292851,541000,1053827,159146000,
4153900,Providence Christian College,CA,195829,312235,544000,1052064,0,
2151500,Central Susquehanna Lpn Career Center,PA,211480,306140,532000,1049620,0,
2195900,Modern Hairstyling Institute,PR,1048362,0,0,1048362,0,
3361400,Fortis College,AL,1046187,0,0,1046187,0,
3104400,Advantage Technical College,PR,1045941,0,0,1045941,0,
361800,Southwestern Christian College,TX,143039,328569,569000,1040608,0,
2220500,God'S Bible School & College,OH,154996,321577,562000,1038573,0,
677500,Rainy River Community College,MN,161267,317295,559000,1037562,0,
2195400,Modern Hairstyling Institute,PR,1036256,0,0,1036256,0,
2277300,Sisseton Wahpeton College,SD,157620,319636,558000,1035256,0,
747300,Choffin Career & Technical Center,OH,186502,307569,539000,1033071,0,
2340500,Saint Louis College Of Health Careers,MO,1026542,0,0,1026542,0,
177800,Vandercook College Of Music,IL,158225,308298,560000,1026523,0,
3874400,Community Christian College,CA,113974,332179,577000,1023153,0,
2092300,Eastwick College - Nutley Campus,NJ,1022459,0,0,1022459,0,
642900,Saint Francis Medical Center,NJ,23963,48506,946000,1018469,0,
3573300,Aviation Institute Of Maintenance,TX,1018117,0,0,1018117,0,
3157600,"Colegio De Cinematografía, Artes Y Televisión",PR,1018034,0,0,1018034,0,
630500,Maine College Of Health Professions,ME,162446,309324,546000,1017770,0,
3468500,Mdt College Of Health Sciences,OH,1017059,0,0,1017059,0,
3122600,Eastern International College,NJ,1016203,0,0,1016203,0,
4229300,Medquest College,KY,1013074,0,0,1013074,0,
2230600,Ogle School Hair Skin Nails,TX,1012829,0,0,1012829,0,
3332600,Delta College,LA,1012095,0,0,1012095,25581000,
3915300,Career Quest Learning Centers,MI,1005286,0,0,1005286,0,
1227700,New York Chiropractic College,NY,220590,275168,509000,1004758,58663000,
2545400,North American Trade Schools,MD,1004497,0,0,1004497,0,
4227200,Bet Medrash Gadol Ateret Torah,NY,196283,293864,511000,1001147,0,
694100,Dallas Christian College,TX,164340,302140,530000,996480,0,
457900,International Business College,IN,995201,0,0,995201,0,
4152900,Studio Academy Of Beauty (The),AZ,994090,0,0,994090,0,
2620000,Sandusky Career Center,OH,174031,292424,527000,993455,0,
533000,Fayette County Career & Technical Institute,PA,195264,292091,506000,993355,0,
3171300,University Of St. Augustine For Health Sciences,CA,993092,0,0,993092,0,
2234900,Antilles College Of Health,PR,985427,0,0,985427,0,
542400,South Central Career Center,MO,176341,286468,522000,984809,0,
1081400,Pittsburgh Institute Of Mortuary Science,PA,170652,293693,519000,983345,0,
653400,Citizens School Of Nursing,PA,174244,292971,516000,983215,0,
853700,Concorde Career College,CA,982367,0,0,982367,0,
129500,Southwestern Law School,CA,212120,269763,499000,980883,0,
2131600,Pennco Tech,NJ,979653,0,0,979653,0,
2522800,Fox College,IL,979641,0,0,979641,0,
3067400,Baldwin Park Adult School,CA,319015,657738,0,976753,0,
226900,Great Lakes Christian College,MI,159906,298456,518000,976362,0,
4117200,Instituto Educativo Premier,PR,974349,0,0,974349,0,
4242800,Coalition Of African American Nurses,IL,125975,244318,604000,974293,0,
2621500,Career College Of Northern Nevada,NV,974259,0,0,974259,0,
2231900,Gemological Institute Of America,CA,176142,251997,543000,971139,0,
3724300,Digipen Institute Of Technology,WA,961951,0,0,961951,0,
2218200,Garnet Career Center,WV,148515,296103,514000,958618,0,
3015100,Alliance Career Center,OH,108179,269624,579000,956803,0,
489900,Upmc Mercy School Of Nursing,PA,175624,284016,496000,955640,0,
3101800,Illinois Media School,IL,954313,0,0,954313,0,
4142500,Touro University Worldwide,CA,87768,313122,551000,951890,0,
2341100,Kenneth Shuler School Of Cosmetology & Nails,SC,951470,0,0,951470,0,
2158500,Ohio Business College,OH,948103,0,0,948103,0,
2594300,Collegeamerica Denver,CO,944384,0,0,944384,0,
2541000,Alaska Career College,AK,941040,0,0,941040,0,
4121800,Criswell College,TX,152588,286200,501000,939788,0,
1198400,Ohr Hameir Theological Seminary,NY,184006,275552,479000,938558,0,
2529800,Wilkes Barre Area Career And Technical Center Practical Nursing Prgm,PA,335061,601805,0,936866,0,
2222900,International Air & Hospitality Academy,WA,936798,0,0,936798,0,
3781300,Pitc Institute,PA,936629,0,0,936629,0,
3122500,Academia Serrant,PR,936113,0,0,936113,0,
1238600,Southeastern Regional Vocational Technical School,MA,156398,277315,502000,935713,0,
888000,Morrison Institute Of Technology,IL,180060,275067,480000,935127,0,
1215400,California Institute Of Integral Studies,CA,352356,577600,0,929956,0,
3855300,Ecclesia College,AR,148173,273519,508000,929692,0,
4120300,Health And Style Institute,NC,927846,0,0,927846,0,
2124500,Franklin Technology Center,MO,202194,261263,464000,927457,0,
2517500,Aaniiih Nakoda College,MT,114359,295974,517000,927333,0,
1310300,California Western School Of Law,CA,196710,256504,474000,927214,0,
3034400,Conservatory Of Recording Arts & Sciences,AZ,926993,0,0,926993,0,
3689400,Faith International University,WA,162349,274839,488000,925188,0,
4271800,Red Lake Nation College,MN,151473,282627,491000,925100,0,
3098600,Career Technology Center Of Lackawanna County,PA,174002,274681,476000,924683,0,
4163300,Compass College Of Cinematic Arts,MI,186951,267935,468000,922886,0,
533500,Central Pennsylvania Institute Of Science And Technology,PA,369675,552704,0,922379,0,
2532200,Lac Courte Oreilles Ojibwe College,WI,31226,125237,765000,921463,0,
2343400,Bellus Academy,CA,915623,0,0,915623,0,
2156200,Technical College Of The Rockies,CO,128974,280929,505000,914903,0,
2497300,Milan Institute,CA,914326,0,0,914326,0,
3946300,Franklin W. Olin College Of Engineering,MA,178424,263423,471000,912847,0,
3147300,Yeshiva D'Monsey,NY,182423,266255,463000,911678,0,
4230100,Rabbinical College Ohr Yisroel,NY,176604,267738,465000,909342,0,
2553600,Diversified Vocational College,CA,908774,0,0,908774,0,
3008600,Cortiva Institute,FL,908597,0,0,908597,0,
4259000,Yeshiva Shaar Ephraim,NY,175684,266626,463000,905310,0,
382000,Salem University,WV,904789,0,0,904789,0,
2245600,Warren County Career Center,OH,107854,256031,539000,902885,0,
3917300,Evergreen Beauty And Barber College,WA,902623,0,0,902623,0,
4181200,Southern California Health Institute (Sochi),CA,902290,0,0,902290,0,
2053700,Eastwick College,NJ,895753,0,0,895753,0,
479800,Mirrer Yeshiva Central Institute,NY,156376,268703,469000,894079,0,
4245600,Yeshivas Maharit D'Satmar,NY,174514,263183,456000,893697,0,
4273800,Yeshiva Gedola Tiferes Yerachmiel,NJ,179422,260236,453000,892658,0,
3323300,Little Priest Tribal College,NE,144184,272758,475000,891942,0,
793000,Concorde Career College,CA,887365,0,0,887365,0,
4252700,Pacific Rim Christian University,HI,156569,266359,464000,886928,0,
3579300,Texas County Technical Institute,MO,155166,263542,468000,886708,0,
303100,Cleveland Institute Of Music (The),OH,186268,250323,450000,886591,0,
3124900,Imagine - Paul Mitchell Partner School,AR,883707,0,0,883707,0,
2491100,Beckfield College,KY,881109,0,0,881109,0,
1037800,Rabbinical College Of Long Island,NY,170473,258635,452000,881108,0,
1230900,University Of Western States,OR,164488,251335,465000,880823,0,
4226700,Alabama College Of Osteopathic Medicine,AL,186805,242819,449000,878624,0,
3853300,Keck Graduate Institute Of Applied Life Sciences,CA,189117,241924,447000,878041,0,
4117300,Dayton School Of Medical Massage,OH,875986,0,0,875986,0,
3973300,Sae Expression College,CA,875264,0,0,875264,0,
123000,Marshall B. Ketchum University,CA,145778,255280,472000,873058,23988000,
2522700,Eastland-Fairfield Career And Technical Schools,OH,133125,230759,509000,872884,0,
4244300,Antioch College,OH,164109,258673,449000,871782,0,
1081300,American Academy Mcallister Institute,NY,93366,283171,495000,871537,0,
3696300,University Of The West,CA,140086,263934,467000,871020,0,
2081400,Arlington Baptist University,TX,151631,262372,457000,871003,0,
1071700,Great Plains Technology Center School District Number 9,OK,353682,517164,0,870846,0,
3177300,San Juan Bautista School Of Medicine,PR,173235,249830,445000,868065,0,
2168900,Kansas Christian College,KS,117258,273937,476000,867195,0,
320800,Northwest Christian University,OR,292486,574500,0,866986,0,
625700,Saint Elizabeth School Of Nursing,IN,136328,266111,464000,866439,0,
2275300,Cabell County Career Technology Center,WV,160620,257572,447000,865192,0,
3128400,Delaware County Technical School,PA,150255,261376,453000,864631,0,
2568100,Texas Barber College,TX,863797,0,0,863797,0,
2228500,Life Chiropractic College West,CA,171227,242238,448000,861465,0,
760700,Concorde Career College,CA,861408,0,0,861408,0,
1256100,Five Towns College,NY,860147,0,0,860147,0,
2060800,"Meridian Technology Center, School District Number 16",OK,302793,556129,0,858922,0,
807100,Concorde Career College,CA,857787,0,0,857787,0,
2169100,Davis College,NY,135671,262894,459000,857565,0,
3264300,South Florida Bible College And Theological Seminary,FL,96848,281055,478000,855903,0,
2161800,Musicians Institute,CA,854505,0,0,854505,0,
835500,James Rumsey Technical Institute,WV,138292,261029,455000,854321,0,
2189000,Mid-East Career And Technology Centers - Adult Education,OH,362414,490347,0,852761,0,
231100,Kuyper College,MI,166221,249551,436000,851772,0,
4171000,Advanced Training Institute,NV,850047,0,0,850047,0,
1004300,Bon Secours Memorial College Of Nursing,VA,141069,254185,452000,847254,0,
3005400,Georgia Career Institute,GA,846937,0,0,846937,0,
2187900,Ashtabula County Technical And Career Campus,OH,124546,222067,499000,845613,0,
1246200,Eastwick College - Hackensack Campus.,NJ,844520,0,0,844520,0,
729100,St. Luke'S College,IA,136761,256703,449000,842464,0,
3921400,White Earth Tribal And Community College,MN,105200,269057,467000,841257,0,
397600,Rabbinical Academy Mesivta Rabbi Chaim Berlin,NY,168667,240703,428000,837370,0,
1046000,American Baptist Theological Seminary,TN,152145,250134,434000,836279,0,
3750300,Prospect College,DC,830854,0,0,830854,0,
3085700,Professional Technical Institution,PR,827459,0,0,827459,0,
4139800,Delaware College Of Art And Design,DE,168154,239395,417000,824549,0,
3382300,North Florida Technical College,FL,134851,249666,438000,822517,0,
4227000,Abc Adult School,CA,133978,210313,478000,822291,0,
622500,Trinity College Of Nursing & Health Sciences,IL,127554,251781,441000,820335,0,
3534400,American Institute Of Alternative Medicine,OH,818622,0,0,818622,0,
2259400,Amberton University,TX,135514,241006,441000,817520,0,
2069000,New York School Of Interior Design,NY,117250,250094,450000,817344,0,
3126200,Green Country Technology Center,OK,157598,237307,421000,815905,0,
3075600,Emma'S Beauty Academy,PR,814149,0,0,814149,0,
168900,Illinois College Of Optometry,IL,174875,223171,413000,811046,0,
3296300,Cortiva Institute,MD,809235,0,0,809235,0,
2350100,Western Area Career & Technology Center,PA,123771,191591,493000,808362,0,
2545200,Chief Dull Knife College,MT,103368,254495,450000,807863,0,
643800,Phillips School Of Nursing At Mount Sinai Beth Israel,NY,151193,236544,419000,806737,0,
2336700,Cuyahoga Valley Career Center,OH,164195,234082,407000,805277,0,
3089200,Nouvelle Institute,FL,805020,0,0,805020,0,
2597300,South Baylo University,CA,213732,227872,361000,802604,0,
3583300,Ohio Institute Of Allied Health,OH,101503,254527,446000,802030,0,
834300,Autry Technology Center District No.15,OK,307354,493832,0,801186,0,
3642300,Institute Of Technology,OR,799110,0,,799110,,
4134800,Aveda Institute - Tallahassee,FL,798287,0,0,798287,0,
1326300,South Hills School Of Business & Technology,PA,795265,0,0,795265,0,
396500,Bay State College,MA,794883,0,0,794883,0,
3011600,Fortis Institute,PA,791394,0,0,791394,0,
2330800,Jrmc School Of Nursing,AR,142391,233208,415000,790599,0,
135200,Denver Seminary,CO,137773,228720,423000,789493,0,
10257900,New England College,NH,411295,0,378000,789295,14646000,
4154200,Carolina College Of Biblical Studies,NC,119702,243633,424000,787335,0,
2577900,Santa Barbara Business College,CA,786894,0,0,786894,0,
3191300,Cuny School Of Law '(The)',NY,141995,225396,417000,784391,0,
3650600,Pc Age,NJ,782767,0,0,782767,0,
4156400,Aviation Institute Of Maintenance,FL,782346,0,0,782346,0,
4149800,Somerset County Technology Center,PA,139358,234539,407000,780897,0,
3842500,Cambridge Institute Of Allied Health And Technology,FL,779045,0,0,779045,0,
4231500,Yeshiva Sholom Shachna,NY,153086,228120,397000,778206,0,
3733300,Baptist University Of The Americas,TX,122224,238328,416000,776552,0,
4149100,Paul Mitchell The School Cincinnati,OH,776215,0,0,776215,0,
1050100,Lakeview College Of Nursing,IL,140717,230720,404000,775437,0,
4128400,Miami Regional University,FL,774452,0,0,774452,0,
2149900,Paul Mitchell The School-Jacksonville,FL,773577,0,0,773577,0,
1128200,Oklahoma State University Center For Health Sciences,OK,144134,220100,407000,771234,0,
1009800,Neumont College Of Computer Science,UT,769673,0,0,769673,0,
4130500,Pacific Northwest University Of Health Sciences,WA,166437,211659,391000,769096,0,
3781400,Industrial Technical College,PR,768357,0,0,768357,0,
3025900,"Liceo De Arte, Diseños Y Comercio",PR,767805,0,0,767805,0,
658300,Western Pennsylvania Hospital School Of Nursing,PA,141885,223212,401000,766097,0,
996400,Central Technology Center School District No. 3,OK,142537,623028,0,765565,0,
1193400,Vermont Law School,VT,151393,215512,398000,764905,0,
3160300,Alaska Vocational Technical Center,AK,71437,252317,441000,764754,0,
764900,Rocky Mountain College Of Art + Design,CO,761314,0,0,761314,0,
2285900,Ucas University Of Cosmetology Arts & Sciences,TX,760609,0,0,760609,0,
2559000,University Of Advancing Computer Technology,AZ,759682,0,0,759682,0,
4251400,Elim Bible Institute And College,NY,151944,221373,386000,759317,0,
3078000,Miami Media School,FL,757634,0,0,757634,0,
4167200,Geisinger Commonwealth School Of Medicine,PA,160035,209453,387000,756488,0,
3051400,Auburn Career Center,OH,124034,228775,402000,754809,0,
4148300,Denver College Of Nursing,CO,753229,0,0,753229,0,
485300,Bradford School,OH,752083,0,0,752083,0,
4152800,Paul Mitchell The School Sacramento,CA,750351,0,0,750351,0,
3125800,Premiere Career College,CA,747470,0,0,747470,0,
216400,New England College Of Optometry (The),MA,163236,204223,378000,745459,0,
2607100,Paul Mitchell The School Boise,ID,740779,0,0,740779,0,
2262400,Yeshiva Ohr Elchonon Chabad - West Coast Talmudical Seminary,CA,286933,453332,0,740265,0,
2554800,Vanguard College Of Cosmetology A Paul Mitchell Partner School-Metaire,LA,736592,0,0,736592,0,
884600,Wright Institute (The),CA,145487,204327,378000,727814,0,
2092500,Laurel Technical Institute,PA,727647,0,0,727647,0,
2306200,Venango County Area Vocational Technical School,PA,134117,197655,395000,726772,0,
4123400,Yeshivas Be'Er Yitzchok,NJ,139993,214403,372000,726396,0,
4167000,Paul Mitchell The School Temecula,CA,725475,0,0,725475,0,
806700,Louisiana State University Health Sciences Center In Shreveport,LA,316992,407364,0,724356,0,
2546300,Yeshiva Of The Telshe Alumni,NY,139972,212344,371000,723316,0,
4193000,Rio Grande Valley College,TX,722800,0,0,722800,0,
3403300,Epic Bible College,CA,93800,227409,400000,721209,0,
351700,Southern College Of Optometry,TN,156253,197963,366000,720216,0,
2350200,Indiana County Technology Center,PA,131498,214580,373000,719078,0,
146400,Wesley Theological Seminary,DC,142919,201191,372000,716110,0,
3752400,Sum Bible College & Theological Seminary,CA,26609,249266,437000,712875,0,
4222000,Arclabs,SC,712771,0,0,712771,0,
4130900,Tricoci University Of Beauty Culture,IN,711717,0,0,711717,0,
2279600,Cortiva Institute,FL,709623,0,0,709623,0,
2234500,Boise Bible College,ID,130055,211493,368000,709548,0,
3894300,Huntsville Bible College,AL,96521,223392,388000,707913,0,
1119200,Beth Hamedrash Shaarei Yosher Institute,NY,133173,209184,363000,705357,0,
2270800,Ameritech College,UT,705243,0,0,705243,0,
2535500,Mercer County Technical Education Center,WV,105541,213047,385000,703588,0,
2237800,Specs Howard School Of Media Arts,MI,702843,0,0,702843,0,
117700,Cogswell Polytechnical College,CA,701472,0,0,701472,0,
2482100,Morehouse School Of Medicine,GA,147523,193537,358000,699060,0,
4182600,Hci College,FL,698258,0,0,698258,0,
3115200,Motoring Technical Training Institute,MA,698220,0,0,698220,0,
2126300,Madison Oneida Boces Practical Nursing Program,NY,89648,178563,430000,698211,0,
3110700,Aviation Institute Of Maintenance,PA,698192,0,0,698192,0,
3023700,Madison Adult Career Center,OH,110102,210003,373000,693105,0,
2159700,New Hope Christian College,OR,127250,206731,359000,692981,0,
865500,Genesis Career College,TN,692917,0,0,692917,0,
3319300,Creative Images Institute Of Cosmetology,OH,692021,0,0,692021,0,
2170000,Swedish Institute,NY,691142,0,0,691142,0,
4182200,Hawaii Medical College,HI,690676,0,0,690676,0,
243500,Southeastern Baptist College,MS,73845,225049,390000,688894,0,
891600,New England Law | Boston,MA,148978,188842,349000,686820,0,
266900,Bank Street College Of Education,NY,124021,197364,365000,686385,49109000,
2333000,Hair Academy,MD,685979,0,0,685979,0,
4276100,Champion Christian College,AR,87078,218514,379000,684592,0,
2570400,Educational Technical College (Edutec),PR,682212,0,0,682212,0,
3723300,Culinary Institute Lenotre,TX,682153,0,0,682153,0,
2550800,Nebraska Indian Community College,NE,77576,219271,385000,681847,0,
1111700,Alliant International University,CA,679282,0,0,679282,0,
3496300,Yeshiva Shaarei Torah Of Rockland,NY,136261,197398,345000,678659,0,
171700,Macmurray College,IL,677656,0,0,677656,0,
4016500,American Institute Of Beauty,FL,676204,0,0,676204,0,
4119400,Aveda Institute - South Florida,FL,676153,0,0,676153,0,
2112200,Great Lakes Institute Of Technology,PA,675003,0,0,675003,0,
971000,Tennessee College Of Applied Technology - Oneida/Huntsville,TN,213467,460696,0,674163,0,
759300,Parisian Beauty Academy Paul Mitchell Partner School,NJ,673639,0,0,673639,0,
999200,Oak Hills Christian College,MN,111319,204257,355000,670576,0,
4159400,Columbia College Of Nursing,WI,121544,199456,348000,669000,0,
944900,Pennco Tech,PA,667974,0,0,667974,0,
3114700,Praxis Institute,FL,663998,0,0,663998,0,
646700,Saint Joseph'S College Of Nursing At St Joseph'S Hospital Health Cente,NY,261644,402069,0,663713,0,
1034200,Southern Oklahoma Area Vocational Technical District #20,OK,252054,409934,0,661988,0,
3065900,Buckeye Career Center,OH,118342,198159,344000,660501,0,
3438300,Pacific Islands University,GU,120440,197531,342000,659971,0,
2098400,Herkimer County Boces Practical Nursing Program,NY,117344,197198,342000,656542,0,
2265100,Yeshiva Derech Chaim,NY,128724,191008,335000,654732,0,
2063700,Sherman College Of Straight Chiropractic,SC,136466,181651,336000,654117,0,
530700,Tennessee College Of Applied Technology--Mcminnville,TN,230898,421547,0,652445,0,
924800,Samaritan Hospital School Of Nursing,NY,110633,197013,343000,650646,0,
2556800,Paul Mitchell The School Salt Lake City,UT,647756,0,0,647756,0,
2576100,Escuela Técnica De Electricidad,PR,644003,0,0,644003,0,
4237200,Montefiore School Of Nursing,NY,94873,199194,349000,643067,0,
4188400,Bais Hamedrash And Mesivta Of Baltimore,MD,124132,187848,326000,637980,0,
4223600,Academy Of Interactive Entertainment,WA,140430,229333,267000,636763,0,
2104900,Sumner College,OR,632989,0,0,632989,0,
288600,Albany Law School Of Union University,NY,117773,180629,334000,632402,0,
4146700,Aviation Institute Of Maintenance,TX,631206,0,0,631206,0,
466900,Upper Cape Cod Regional Technical School,MA,120421,180192,330000,630613,0,
2545900,Hypnosis Motivation Institute,CA,56543,136342,437000,629885,0,
3098300,Putnam Career & Technical Center,WV,106383,190673,332000,629056,0,
2157900,Rochester General-Isabella Graham Hart School Of Practical Nursing,NY,229264,397898,0,627162,0,
3490300,Paul Mitchell The School Chicago,IL,626698,0,0,626698,0,
4168700,Peloton College,TX,626237,0,0,626237,0,
613600,National Aviation Academy - New England,MA,625133,0,0,625133,0,
2220800,Career & Technology Education Centers Of Licking County,OH,198541,425891,0,624432,0,
369700,Vermont College Of Fine Arts,VT,142286,169130,313000,624416,0,
888700,Concorde Career College,OR,623986,0,0,623986,0,
4206300,Florida Vocational Institute,FL,623164,0,0,623164,0,
2275100,Concorde Career Institute,FL,621612,0,0,621612,0,
1209200,Kenneth Shuler School Of Cosmetology,SC,620853,0,0,620853,0,
3570300,Carolina Christian College,NC,114861,184859,321000,620720,0,
2128700,Central School Of Practical Nursing,VA,31183,45291,541000,617474,0,
4235000,Felbry College-School Of Nursing,OH,617396,0,0,617396,0,
791600,Franklin County Career And Technology Center,PA,89503,190443,337000,616946,0,
1090600,Cincinnati College Of Mortuary Science,OH,134679,175892,306000,616571,0,
2116900,Upper Valley Career Center,OH,73618,197763,343000,614381,0,
1153700,Mid-America Area Vocational-Technical School District No. #8,OK,253644,359584,0,613228,0,
553100,Grand River Technical School,MO,113559,182186,317000,612745,0,
3052300,Kenneth Shuler School Of Cosmetology & Hair Design,SC,611571,0,0,611571,0,
1198900,Talmudical Academy,NJ,122458,178092,310000,610550,0,
2104000,Harris School Of Business,NJ,609828,0,0,609828,0,
262600,Princeton Theological Seminary,NJ,143741,163528,302000,609269,1127362000,
168500,Hebrew Theological College,IL,107582,181465,319000,608047,0,
2578200,Nossi College Of Art,TN,606694,0,0,606694,0,
3555300,Southeastern Institute,NC,605946,0,0,605946,0,
2158300,Mifflin County Academy Of Science And Technology,PA,117767,177636,310000,605403,0,
3127100,Yeshivas Novominsk,NY,163597,160631,281000,605228,0,
4215900,Yeshiva Gedolah Kesser Torah,NY,115347,177692,310000,603039,0,
902200,Associated Technical College,CA,602768,0,0,602768,0,
4167100,Aveda Institute Denver,CO,602184,0,0,602184,0,
3224300,New Professions Technical Institute,FL,600447,0,0,600447,0,
3089100,Georgia Institute Of Cosmetology,GA,599634,0,0,599634,0,
4137800,Aveda Institute Columbus,OH,599625,0,0,599625,0,
3650300,Tri-Community Adult Education,CA,68720,170637,360000,599357,0,
644500,Bill And Sandra Pomeroy College Of Nursing At Crouse Hospital,NY,207843,391341,0,599184,0,
3537300,New York Automotive & Diesel Institute,NY,598781,0,0,598781,0,
4194500,Aveda Institute Tucson,AZ,598691,0,0,598691,0,
4195400,Unitek College,CA,598178,0,0,598178,0,
888600,Portage Lakes Career Center,OH,106470,179039,312000,597509,0,
3777300,Paul Mitchell The School Gastonia,NC,595930,0,0,595930,0,
730500,Porter And Chester Institute Of Hamden,CT,595156,0,0,595156,0,
4102300,New Age Training,NY,594376,0,0,594376,0,
717800,Western Seminary,OR,100084,172607,319000,591691,0,
4141400,Laurus College,CA,591076,0,0,591076,0,
632200,Signature Healthcare Brockton Hospital School Of Nursing,MA,216076,374477,0,590553,0,
4146000,National Career College,CA,589577,0,0,589577,0,
3776300,Auguste Escoffier School Of Culinary Arts,CO,588381,0,0,588381,0,
2074000,Branford Hall Career Institute,CT,588348,0,0,588348,0,
1252300,Talmudical Yeshiva Of Philadelphia,PA,111069,156403,320000,587472,0,
2197900,North Bennet Street School,MA,119089,162637,304000,585726,0,
274100,American Jewish University,CA,111218,170995,302000,584213,0,
3266300,Bethesda University,CA,222826,361033,0,583859,0,
650700,Trinity Health System School Of Nursing,OH,99922,176816,307000,583738,0,
4203800,Woodruff Medical Training And Testing,GA,583499,0,0,583499,0,
2335700,Baton Rouge General Medical Center,LA,69310,186886,326000,582196,0,
2150600,Cosmetology And Spa Academy,IL,582054,0,0,582054,0,
4003300,Blake Austin College,CA,581595,0,0,581595,0,
3076500,Fayette Institute Of Technology,WV,106163,160267,314000,580430,0,
849500,Jamestown Business College,NY,577492,0,0,577492,0,
2188900,Hobe Sound Bible College,FL,75745,173384,328000,577129,0,
3440400,Marian Health Careers Center,CA,575634,0,0,575634,0,
490200,Penn Commercial Business/Technical School,PA,575574,0,0,575574,0,
1064100,Southern Westchester Boces,NY,92799,173278,307000,573077,0,
4264900,Yeshiva Chemdas Hatorah,NJ,112892,167282,291000,571174,0,
3772300,Saginaw Chippewa Tribal College,MI,83912,176488,309000,569400,0,
2124000,Orange Ulster Boces School Of Practical Nursing,NY,97357,170810,301000,569167,0,
3124200,Nova College Of Puerto Rico,PR,568986,0,0,568986,0,
3109000,School Of Communication Arts Of North Carolina,NC,568133,0,0,568133,0,
644300,Cochran School Of Nursing Saint John'S Riverside Hosp,NY,86672,174690,304000,565362,0,
4115600,Mayfield College,CA,564629,0,0,564629,0,
2251200,Schuylkill Technology Centers,PA,106526,161766,294000,562292,0,
3027700,Pacific College Of Oriental Medicine,CA,561804,0,0,561804,0,
2172700,Concorde Career Institute,FL,561628,0,0,561628,0,
2189300,Emma'S Beauty Academy,PR,561434,0,0,561434,0,
4125600,Career School Of Ny,NY,74214,178126,309000,561340,0,
1220300,St. Peter'S Hospital College Of Nursing,NY,84543,172938,302000,559481,0,
4251500,Beth Medrash Of Asbury Park,NJ,109145,164258,286000,559403,0,
485500,Davis College,OH,99923,0,459000,558923,0,
4178400,Vogue College Of Cosmetology,TX,558728,0,0,558728,0,
3627600,Florida Education Institute,FL,558247,0,0,558247,0,
3010400,Crescent City School Of Gaming & Bartending,LA,557634,0,0,557634,0,
856800,Vet Tech Institute,PA,556560,0,0,556560,0,
3570400,English Center (The),FL,91968,162784,301000,555752,0,
2586900,Harris School Of Business,NJ,554114,0,0,554114,0,
4162800,Paul Mitchell The School Modesto,CA,553609,0,0,553609,0,
3043900,Newschool Of Architecture And Design,CA,553090,0,0,553090,0,
2185800,Moler Barber College,CA,551182,0,0,551182,0,
2199300,Orleans Niagara Boces,NY,113519,160272,277000,550791,0,
489000,Central Penn College,PA,550693,0,0,550693,0,
4165900,Paul Mitchell The School Fresno,CA,550245,0,0,550245,0,
992900,Suny College Of Optometry,NY,118717,151252,280000,549969,0,
3098700,Milan Institute,CA,549033,0,0,549033,0,
1148100,Divers Institute Of Technology,WA,548712,0,0,548712,0,
1186600,Lu Ross Academy,CA,547287,0,0,547287,0,
3965400,Myrangel Beauty Institute,PR,546026,0,0,546026,0,
2255400,Toni&Guy Hairdressing Academy,CA,545266,0,0,545266,0,
1309500,Salon Success Academy,CA,543888,0,0,543888,0,
3011500,Fortis Institute,PA,542910,0,0,542910,0,
274000,Jewish Theological Seminary Of America (The),NY,118674,147972,276000,542646,0,
177900,Illinois Eastern Community Colleges - Wabash Valley College,IL,541848,0,0,541848,0,
4081300,Bais Medrash Toras Chesed,NJ,68038,171733,302000,541771,0,
3816300,Artistic Nails & Beauty Academy,FL,541307,0,0,541307,0,
3025800,Dawn Career Institute,DE,539645,0,0,539645,0,
2337200,Pj'S College Of Cosmetology,KY,539531,0,0,539531,0,
729700,Spartan College Of Aeronautics And Technology,CO,539465,0,0,539465,0,
3356300,Medical Training College,LA,539363,0,0,539363,0,
705000,Bellus Academy,CA,539166,0,0,539166,0,
725300,Federico Beauty Institute,CA,538895,0,0,538895,0,
4129800,Mediatech Institute,TX,538457,0,0,538457,0,
3098000,St. John'S College,IL,100955,156367,280000,537322,217294000,
2272900,Rockland County Boces Adult Education,NY,104744,158385,274000,537129,0,
4179100,Verve College,IL,537056,0,0,537056,0,
2232500,Union County Vocational Technical Schools,NJ,100104,153054,280000,533158,0,
660600,Baptist Health System School Of Health Professions,TX,531618,0,0,531618,0,
2129000,Triangle Tech,PA,530918,0,0,530918,0,
3126300,Aviation Institute Of Maintenance,VA,530011,0,0,530011,0,
2223300,Magdalen College,NH,103591,155397,271000,529988,0,
4151800,Temple (The): A Paul Mitchell Partner School,MD,528840,0,0,528840,0,
4193800,Shepherds College,WI,99604,155176,270000,524780,0,
4037500,Academy Of Hair Design,MO,524704,0,0,524704,0,
2203900,Erie Institute Of Technology,PA,519694,0,0,519694,0,
3303300,Northwest Educational Center,TX,519264,0,0,519264,0,
274900,New York College Of Podiatric Medicine,NY,115225,141984,262000,519209,0,
3043100,Thomas More College Of Liberal Arts,NH,102524,151166,264000,517690,0,
4221000,"Standard Healthcare Services, College Of Nursing",VA,516309,0,0,516309,0,
231300,Sacred Heart Major Seminary,MI,74193,156719,285000,515912,0,
4240200,Aviation Institute Of Maintenance,CA,512166,0,0,512166,0,
2553700,Nueta Hidatsa Sahnish College,ND,83694,157142,270000,510836,0,
616500,Los Angeles County College Of Nursing And Allied Health,CA,174062,336733,0,510795,0,
2363800,Yeshiva Gedolah Of Greater Detroit,MI,100742,149742,260000,510484,0,
1274300,Benjamin Franklin Career & Technical Center,WV,96740,132653,280000,509393,0,
4248400,Academy Of Interactive Entertainment,LA,88545,153694,267000,509239,0,
405400,Hebrew Union College - Jewish Institute Of Religion,NY,104168,141966,262000,508134,0,
202700,Saint Joseph Seminary College,LA,98377,145762,263000,507139,0,
3400300,Quest College,TX,506799,0,0,506799,0,
500700,West Virginia Junior College,WV,506663,0,0,506663,0,
3812300,Omnitech Institute,GA,506117,0,0,506117,0,
3242300,Career Networks Institute,CA,505137,0,0,505137,0,
4239500,Virginia University Of Integrative Medicine,VA,79436,149419,276000,504855,0,
2238500,Central Oklahoma College,OK,504384,0,0,504384,0,
3616300,Aviation Institute Of Maintenance,MO,503111,0,0,503111,0,
2104400,Spa Tech Institute,ME,502984,0,0,502984,0,
2144800,Vet Tech Institute Of Houston,TX,502030,0,0,502030,0,
4139000,Midwestern Career College,IL,501791,0,0,501791,0,
3034200,Washington County Career Center Adult Education,OH,146812,354896,0,501708,0,
1048900,American National University,KY,501696,0,0,501696,0,
3429600,Atlantic Institute Of Oriental Medicine,FL,130647,129468,239000,499115,0,
470700,Covenant Theological Seminary,MO,88666,144086,266000,498752,0,
2206200,Beauty Institute (The),PA,497279,0,0,497279,0,
189500,Waldorf University,IA,497220,0,0,497220,0,
4154900,National Career Institute,NJ,497128,0,0,497128,0,
4121000,Mycomputercareer.Com /Techskills,IN,495594,0,0,495594,0,
4180000,Cinta Aveda Institute,CA,493584,0,0,493584,0,
2312000,Bergen County Technical Schools,NJ,76107,149957,266000,492064,0,
3999300,Beaumont Adult School,CA,156954,334960,0,491914,0,
4234900,Amg School Of License Practical Nursing,NY,491430,0,0,491430,0,
903200,Empire College,CA,490975,0,0,490975,0,
3706300,Hollywood Institute,FL,490367,0,0,490367,0,
545200,Teterboro School Of Aeronautics,NJ,490330,0,0,490330,0,
2326800,Meridian College,FL,488558,0,0,488558,0,
527900,Greater Lowell Regional Vocational Technical School,MA,94030,134707,259000,487737,0,
3235300,Massachusetts School Of Law At Andover,MA,110861,131604,243000,485465,0,
1005200,Jefferson Lewis Boces Program Of Practical Nursing,NY,105234,138888,241000,485122,0,
2174400,Triangle Tech,PA,484941,0,0,484941,0,
4147000,Paul Mitchell The School Atlanta,GA,484422,0,0,484422,0,
3025000,Texas College Of Cosmetology,TX,483500,0,0,483500,0,
849400,Hohokus School Of Trade And Technical Sciences,NJ,483327,0,0,483327,0,
2169600,Clearfield County Career And Technology Center,PA,87950,136055,257000,481005,0,
1173500,Pike Lincoln Technical Center,MO,67332,107217,305000,479549,0,
3127500,Advanced Technology Institute,VA,479439,0,0,479439,0,
3713300,Beis Medrash Heichal Dovid,NY,96883,137156,242000,476039,0,
2578400,Maryland University Of Integrative Health,MD,91890,134889,249000,475779,0,
1285000,International Salon And Spa Academy,CO,475449,0,0,475449,0,
4164700,Keweenaw Bay Ojibwa Community College,MI,68566,148467,258000,475033,0,
3555400,Southeastern Institute,SC,473641,0,0,473641,0,
3062400,Mount Diablo Adult Education,CA,68958,140698,263000,472656,0,
3457300,Allegheny Wesleyan College,OH,83992,141323,246000,471315,0,
3965500,Hair Expressions Academy,MD,470791,0,0,470791,0,
1267000,Bel - Rea Institute Of Animal Technology,CO,470581,0,0,470581,0,
1057300,West Virginia Junior College,WV,470415,0,0,470415,0,
2222000,American Film Institute Conservatory,CA,98640,130412,241000,470052,0,
4261500,Mechon L'Hoyroa,NY,91885,138220,239000,469105,0,
4173700,Grace College Of Divinity,NC,71597,143192,251000,465789,0,
4187800,Cybertex Institute Of Technology,TX,465548,0,0,465548,0,
4250900,Inter American University Of Puerto Rico - School Of Law,PR,193606,269630,0,463236,0,
978200,Saint Luke'S College Of Health Sciences,MO,462823,0,0,462823,0,
4186300,Paul Mitchell The School Las Vegas,NV,462659,0,0,462659,0,
4171400,Aveda Institute Portland,OR,461109,0,0,461109,0,
4147600,Aveda Institute Las Vegas,NV,458983,0,0,458983,0,
355600,Commonwealth Institute Of Funeral Service,TX,64090,143732,251000,458822,0,
3736300,Advance Beauty College,CA,458495,0,0,458495,0,
411700,Grady Health System,GA,90793,133510,234000,458303,0,
1055100,New York School For Medical & Dental Assistants,NY,457757,0,0,457757,0,
3561400,Susquehanna County Career & Technology Center,PA,53535,91598,312000,457133,0,
2160900,Pci Academy,IA,454747,0,0,454747,0,
648300,Watts College Of Nursing,NC,42191,55179,355000,452370,0,
4192200,Athena Career Academy,OH,451504,0,0,451504,0,
4194000,Treasure Coast Technical College,FL,53915,142662,254000,450577,0,
551900,Diman Regional Vocational Technical Institute,MA,81241,134391,234000,449632,0,
2073200,Telshe Yeshiva-Chicago,IL,86628,131342,230000,447970,0,
3065000,Paul Mitchell The School Richland,WA,447875,0,0,447875,0,
4164600,D. A. Dorsey Technical College,FL,51116,143641,253000,447757,0,
2602300,Central Coast College,CA,447424,0,0,447424,0,
3868300,World Mission University,CA,52382,142130,252000,446512,0,
4158200,Paul Mitchell The School Sherman Oaks,CA,446039,0,0,446039,0,
2192800,Walnut Hill College,PA,445337,0,0,445337,0,
2123200,Aveda Institute Minneapolis,MN,445074,0,0,445074,0,
4262200,Elyon College,NY,79445,124036,241000,444481,0,
2360800,Provo College,UT,443357,0,0,443357,0,
2338400,Fort Pierce Beauty Academy,FL,443123,0,0,443123,0,
336400,Saint Charles Borromeo Seminary,PA,62584,135207,245000,442791,0,
3108600,Compu-Med Vocational Careers,FL,442546,0,0,442546,0,
996300,Caddo-Kiowa Area Vocational-Technical School District No. 2,OK,169573,272152,0,441725,0,
2287800,National Tractor Trailer School,NY,439995,0,0,439995,0,
4264400,Yeshiva Gedolah Tiferes Boruch,NJ,86883,128806,224000,439689,0,
752900,Chester County Intermediate Unit Practical Nursing Program,PA,158967,280350,0,439317,0,
4157800,Grace Mission University,CA,61227,136645,241000,438872,0,
2287900,Raphael'S School Of Beauty Culture,OH,438150,0,0,438150,0,
4147200,Tricoci University Of Beauty Culture,IL,436904,0,0,436904,0,
2603700,Oregon College Of Oriental Medicine,OR,100095,117968,218000,436063,0,
2178900,Jolie Health And Beauty Academy,PA,435974,0,0,435974,0,
4147500,Tricoci University Of Beauty Culture,IL,435780,0,0,435780,0,
843700,Clinton-Essex-Warren-Washington Boces,NY,82722,128983,224000,435705,0,
3758300,Bayamon Community College,PR,435133,0,0,435133,0,
720300,Salon Success Academy,CA,434633,0,0,434633,0,
2556100,Eti School Of Skilled Trades,IL,434609,0,0,434609,0,
978600,Illinois Eastern Community Colleges - Lincoln Trail College,IL,434306,0,0,434306,0,
552300,Blue Hills Regional Technical School,MA,84964,127079,221000,433043,0,
3409500,Chester Career College,VA,431590,0,0,431590,0,
235700,Luther Seminary,MN,74012,125262,232000,431274,108716000,
2341700,Career Academy Of Hair Design,AR,429737,0,0,429737,0,
4238600,Gould'S Academy,TN,429649,0,0,429649,0,
2140700,Canton City School District Adult Career & Technical Education,OH,181545,247976,0,429521,0,
3409600,Bennett Career Institute,DC,429212,0,0,429212,0,
4156300,University Of Fort Lauderdale,FL,61344,134315,233000,428659,0,
2301400,Ohio Valley College Of Technology,OH,428200,0,0,428200,0,
3970400,Wellspring School Of Allied Health,MO,428142,0,0,428142,0,
658200,Washington Hospital (The),PA,75704,127547,224000,427251,0,
2524500,Ralph R Willis Career And Technical Center,WV,73861,105807,247000,426668,0,
2195500,Modern Hairstyling Institute,PR,426601,0,0,426601,0,
4145700,Paul Mitchell The School Springfield,MO,426043,0,0,426043,0,
3461300,Ilisagvik College,AK,36806,136862,248000,421668,0,
2492600,Eastern Center For Arts And Technology-Practical Nursing,PA,157939,263505,0,421444,0,
4252000,Yeshiva Gedolah Shaarei Shmuel,NJ,85372,121986,214000,421358,0,
4155200,Oliver Finley Academy Of Cosmetology,ID,420835,0,0,420835,0,
3104300,Career Technical Institute,DC,420528,0,0,420528,0,
2203300,Gene Juarez Beauty Schools,WA,420399,0,0,420399,0,
1085400,Thomas Jefferson School Of Law,CA,116684,106572,197000,420256,0,
520400,Beal College,ME,419913,0,0,419913,0,
531200,Red River Technology Center School District 19,OK,156175,263657,0,419832,0,
3876300,Culpeper Cosmetology Training Center,VA,83682,119538,213000,416220,0,
2577000,Paul Mitchell The School - Esani,GA,415434,0,0,415434,0,
4204500,Elaine Sterling Institute(The),GA,414178,0,0,414178,0,
4124500,Mycomputercareer.Com /Techskills,OH,414059,0,0,414059,0,
325100,Curtis Institute Of Music,PA,86460,114363,213000,413823,253189000,
539900,Monmouth County Vocational School District,NJ,60651,128717,224000,413368,0,
2169900,Assabet Valley Regional Vocational School,MA,82100,120106,211000,413206,0,
4217800,Boca Beauty Academy,FL,412160,0,0,412160,0,
3014900,Platt College,CO,412152,0,0,412152,0,
4175300,Penrose Academy,AZ,412035,0,0,412035,0,
1205100,Pro Way Hair School,GA,408553,0,0,408553,0,
3018500,Bene'S Career Academy,FL,406818,0,0,406818,0,
2235600,Erie 2 - Chautauqua - Cattaraugus Boces,NY,165833,239792,0,405625,0,
4265500,Icohs College,CA,41928,119635,243000,404563,0,
4194200,Aparicio-Levy Technical College,FL,45310,126999,231000,403309,0,
4118300,Northcoast Medical Training Academy,OH,402690,0,0,402690,0,
4144500,Paul Mitchell The School Rexburg,ID,401899,0,0,401899,0,
3883400,Aviation Institute Of Maintenance,VA,401732,0,0,401732,0,
2173900,Ulster County Boces School Of Practical Nursing,NY,76934,110102,214000,401036,0,
1258000,Saint Louis Christian College,MO,59391,124410,217000,400801,0,
643500,Arnot Ogden Medical Center,NY,79464,117203,204000,400667,0,
3176300,Aviation Institute Of Maintenance,IN,400623,0,0,400623,0,
2223700,Robert Fiance Beauty Schools,NJ,400511,0,0,400511,0,
2110900,Cattaraugus/Allegany/Erie/Wyoming Boces,NY,58802,122681,217000,398483,0,
3070900,Southeast Missouri Hospital College Of Nursing And Health Sciences,MO,131509,266731,0,398240,0,
3100900,Luther Rice College & Seminary,GA,23030,135831,239000,397861,0,
1150500,Tricoci University Of Beauty Culture,IN,396317,0,0,396317,0,
644800,"Ellis Medicine, The Belanger School Of Nursing",NY,78739,115012,202000,395751,0,
2178500,Eagle Gate College,UT,395657,0,0,395657,0,
783900,Triangle Tech,PA,394320,0,0,394320,0,
2353100,Northern Tier Career Center,PA,73110,117063,204000,394173,0,
2319200,Lake Forest Graduate School Of Management,IL,62548,116332,215000,393880,0,
2591600,North-West College,CA,393842,0,0,393842,0,
4235300,Polytech Adult Education,DE,47434,123421,222000,392855,0,
2521200,Arlington Career Institute,TX,391614,0,0,391614,0,
2068300,Douglas Education Center,PA,391261,0,0,391261,0,
4160700,Avenue Five Institute,TX,391249,0,0,391249,0,
2584900,First Institute,IL,390859,0,0,390859,0,
3611400,Florida Barber Academy,FL,390387,0,0,390387,0,
2121100,Midwest Institute,MO,389911,0,0,389911,0,
3740400,Ati College,CA,83260,0,306000,389260,0,
2497500,Clinton Technical School,MO,75280,113774,200000,389054,0,
3964400,International School Of Beauty,CA,386363,0,0,386363,0,
2171900,Ailey School (The),NY,76403,111889,197000,385292,0,
3225300,American University Of Health Sciences,CA,384752,0,0,384752,0,
904700,Huntington Junior College Of Business,WV,384451,0,0,384451,0,
4173200,Taylor Andrews Academy Of Hair Design,UT,383197,0,0,383197,0,
4256800,Arkansas Colleges Of Health Education,AR,47138,117888,218000,383026,0,
1082700,David Pressley Professional School Of Cosmetology,MI,382850,0,0,382850,0,
2218300,Southwest School Of Business & Technical Careers,TX,381421,0,0,381421,0,
2204200,"Chattanooga College - Medical, Dental And Technical Careers",TN,381353,0,0,381353,0,
1206400,Hamilton Technical College,IA,380408,0,0,380408,0,
1151900,Joseph'S College Cosmetology,NE,379798,0,0,379798,0,
4212400,Mingo Extended Learning Center,WV,59512,108657,211000,379169,0,
2528300,Tdds Technical Institute,OH,379013,0,0,379013,0,
3645400,"Rudy & Kelly Academy, A Paul Mitchell Partner School",VA,378939,0,0,378939,0,
4083300,Academy For Careers And Technology,SC,64795,114788,199000,378583,0,
528800,Kirksville Area Technical Center,MO,47216,86135,245000,378351,0,
1323200,Academy Of Hair Design,NV,375960,0,0,375960,0,
2209200,Taylortown School Of Beauty,MI,375859,0,0,375859,0,
2238100,Minnesota School Of Cosmetology,MN,375857,0,0,375857,0,
3443300,New York College Of Traditional Chinese Medicine,NY,84673,102149,189000,375822,0,
4133700,New York Medical Career Training Center,NY,375729,0,0,375729,0,
2603800,Lorain County Jvs Adult Career Center,OH,35237,115755,224000,374992,0,
3008700,Southwest Technology Center School District # 27,OK,113543,261363,0,374906,0,
4133900,Futura Career Institute,FL,374889,0,0,374889,0,
3002100,Kentucky Mountain Bible College,KY,68799,111533,194000,374332,0,
4147100,Tricoci University Of Beauty Culture,IL,373874,0,0,373874,0,
4142300,Aveda Arts & Sciences Institute Corpus Christi,TX,373504,0,0,373504,0,
4205200,Wade Gordon Hairdressing Academy,TX,373069,0,0,373069,0,
1235000,Phagans' School Of Hair Design,OR,372489,0,0,372489,0,
2277500,House Of Heavilin Beauty College,MO,372084,0,0,372084,0,
363500,Texas Chiropractic College,TX,77399,103434,191000,371833,0,
311400,Firelands Regional Medical Center,OH,71365,109413,191000,371778,0,
311500,Rabbinical College Of Telshe,OH,68695,101838,201000,371533,0,
405800,Gratz College,PA,54996,111053,205000,371049,0,
2057400,Roane Jackson Technical Center,WV,73406,108699,188000,370105,0,
4216100,Yeshiva Yesodei Hatorah,NJ,73641,107070,188000,368711,0,
4170700,Paul Mitchell The School St Louis,MO,368274,0,0,368274,0,
904300,Elmira Business Institute,NY,367057,0,0,367057,0,
3416500,Dallas Nursing Institute,TX,366585,0,0,366585,0,
2277400,South Coast College,CA,366087,0,0,366087,0,
2202300,Pittsburgh Career Institute,PA,364095,0,0,364095,0,
2056400,Capri Cosmetology Learning Center,NY,363273,0,0,363273,0,
2334300,Empire Beauty School,OH,363192,0,0,363192,0,
2153100,Paul Mitchell The School Murfreesboro,TN,363105,0,0,363105,0,
4187400,John Amico School Of Hair Design,IL,362538,0,0,362538,0,
3626300,Brown Aveda Institute,OH,362519,0,0,362519,0,
820000,Upmc Jameson School Of Nursing,PA,71186,106156,185000,362342,0,
927700,E C Goodwin Technical High School,CT,72504,101723,188000,362227,0,
3240300,Toni & Guy Hairdressing Academy,MA,362087,0,0,362087,0,
2616100,Jean Madeline Aveda Institute,PA,361534,0,0,361534,0,
2563000,Raphael'S School Of Beauty Culture,OH,360731,0,0,360731,0,
4266800,Caribbean Aviation Training Institute,PR,360410,0,0,360410,0,
2546200,Laurel Business Institute,PA,360370,0,0,360370,0,
245700,Concordia Seminary,MO,61962,104619,193000,359581,160249000,
2275500,Paul Mitchell The School Knoxville,TN,358657,0,0,358657,0,
2087600,Concordia Theological Seminary,IN,65681,102693,190000,358374,0,
2597400,Pontotoc Technology Center District #14,OK,145011,212946,0,357957,0,
339300,Westminster Theological Seminary,PA,96630,165242,95000,356872,0,
3914300,"Calc, Institute Of Technology",IL,356366,0,0,356366,0,
3714300,Trend Barber College,TX,356178,0,0,356178,0,
3079000,Eti Technical College Of Niles,OH,355710,0,0,355710,0,
4175200,Paul Mitchell The School East Bay,CA,355653,0,0,355653,0,
2552300,Colegio Mayor De Tecnologia,PR,355224,0,0,355224,0,
2191600,Torah Temimah Talmudical Seminary,NY,66694,104416,184000,355110,0,
3691400,Ave Maria School Of Law,FL,74489,98550,182000,355039,0,
4138700,Paul Mitchell The School - Pasadena,CA,354896,0,0,354896,0,
3923300,Precision Manufacturing Institute,PA,69348,104138,181000,354486,0,
3120700,New York Conservatory For Dramatic Arts (The),NY,354280,0,0,354280,0,
4267800,Bais Binyomin Academy,NY,66331,104904,183000,354235,0,
4231900,Alamo City Barber College,TX,354063,0,0,354063,0,
3253300,Paul Mitchell The School Memphis,TN,353187,0,0,353187,0,
4137500,Tricoci University Of Beauty Culture,IL,352709,0,0,352709,0,
4260900,Mystros Barber Academy,TX,58383,89101,205000,352484,0,
4106300,Palm Beach Academy Of Health & Beauty,FL,352289,0,0,352289,0,
4137300,Cayce/Reilly School Of Massage,VA,61587,105979,184000,351566,0,
1040500,Pinnacle Career Institute,MO,349930,0,0,349930,0,
778300,Middle Tennessee School Of Anesthesia,TN,56794,102676,190000,349470,0,
4170300,Beauty Academy Of South Florida,FL,348763,0,0,348763,0,
385000,Holy Family College,WI,348751,0,0,348751,0,
2125600,Michigan College Of Beauty-Troy,MI,348449,0,0,348449,0,
3102000,"Rivertown School Of Beauty, Barber, Skin Care And Nails",GA,348039,0,0,348039,0,
4145900,Celebrity School Of Beauty,FL,347719,0,0,347719,0,
2261200,G Skin & Beauty Institute,IL,347284,0,0,347284,0,
224200,Calvin Theological Seminary,MI,71301,96593,179000,346894,0,
2610500,Xenon International Academy Ii,NE,346579,0,0,346579,0,
3327300,Hair Academy Ii,MD,345610,0,0,345610,0,
2505900,Shor Yoshuv Rabbinical College,NY,59797,101440,184000,345237,0,
2535600,Clear Creek Baptist Bible College,KY,41384,110307,192000,343691,0,
4144000,Fairfax University Of America,VA,78295,93380,172000,343675,0,
3808300,Institute Of Beauty And Wellness (The),WI,343456,0,0,343456,0,
3077500,Rabbi Jacob Joseph School,NJ,72804,98114,172000,342918,0,
2548500,Cosmetology Training Center,LA,128629,0,213000,341629,0,
4144300,Institute Of Culinary Education,NY,341532,0,0,341532,0,
3347300,International Baptist College And Seminary,AZ,70347,98089,172000,340436,0,
3678300,Pima Medical Institute,NM,340233,0,0,340233,0,
3248300,Boston Baptist College,MA,61817,101261,177000,340078,0,
329100,United Lutheran Seminary,PA,56158,99382,184000,339540,0,
3593300,Southwest Institute Of Healing Arts,AZ,339100,0,0,339100,0,
4170200,Paul Mitchell The School Colorado Springs,CO,338720,0,0,338720,0,
4259800,California Institute Of Arts & Technology,CA,338044,0,0,338044,0,
4116600,Taylor College,FL,337759,0,0,337759,0,
3104500,Atlanta Institute Of Music And Media,GA,337362,0,0,337362,0,
4225700,Cleveland Barber College,OH,337078,0,0,337078,0,
4256200,Kenny'S Academy Of Barbering,IN,335777,0,0,335777,0,
3412300,Advanced Barber College & Hair Design,TX,335473,0,0,335473,0,
2145800,Cayuga Onondaga Boces,NY,59419,100658,175000,335077,0,
3804400,Gwinnett College,GA,334880,0,,334880,0,
4151700,Bella Capelli Academy A Paul Mitchell Partner School,PA,334723,0,0,334723,0,
4229400,Midfield Institute Of Cosmetology,AL,38911,93012,202000,333923,0,
3066300,Bryan University,MO,333687,0,0,333687,0,
2250900,Eastern Oklahoma County Technology Center School District #23,OK,114478,218825,0,333303,0,
3727500,Moore Career College,LA,332337,0,0,332337,0,
4207500,Medical Career Institute,NJ,332030,0,0,332030,0,
162800,American Academy Of Art,IL,331941,0,0,331941,0,
4233700,"Christine Valmy International School Foresthetics, Skin Care & Make-Up",NY,331195,0,0,331195,0,
4132700,Healthcare Career College,CA,331157,0,0,331157,0,
3032300,School Of Automotive Machinists & Technology,TX,330911,0,0,330911,0,
4256700,Reformed University,GA,70509,93560,166000,330069,0,
3681300,California Healing Arts College,CA,329263,0,0,329263,0,
397400,Mesivtha Tifereth Jerusalem Of America,NY,66112,95479,167000,328591,0,
4250100,Santa Barbara And Ventura Colleges Of Law (The),CA,54315,101170,173000,328485,0,
1192600,Leon'S Beauty School,NC,328351,0,0,328351,0,
3061100,Genesis Career College,TN,328276,0,0,328276,0,
3355400,Richmont Graduate University,TN,62656,92894,172000,327550,0,
1152300,Morris County School Of Technology,NJ,68148,94184,165000,327332,0,
826300,Award Beauty School,MD,327046,0,0,327046,0,
4265200,Women'S Institute Of Torah Seminary,MD,61745,96119,169000,326864,0,
128800,Claremont School Of Theology,CA,66104,91565,169000,326669,0,
3097700,Central California School Of Continuing Education,CA,326010,0,0,326010,0,
4261200,Yeshiva Bais Aharon,NJ,64039,95577,166000,325616,0,
2316600,Cortiva Institute,CT,325544,0,0,325544,0,
2258400,Aveda Arts & Sciences Institute Baton Rouge,LA,325463,0,0,325463,0,
320300,Mount Angel Seminary,OR,71691,90729,163000,325420,0,
466600,American College For Medical Careers,FL,323870,0,0,323870,0,
2317300,Tricoci University Of Beauty Culture,IL,323319,0,0,323319,0,
2224600,Tri-State Cosmetology Institute,TX,322549,0,0,322549,0,
2068000,United Technical Center,WV,57801,87433,177000,322234,0,
2064300,Sierra College Of Beauty,CA,321871,0,0,321871,0,
4132900,Z Hair Academy,KS,321716,0,0,321716,0,
4269300,Yeshiva Gedolah Of Cliffwood,NJ,64764,92377,164000,321141,0,
3009500,Winston - Salem Barber School,NC,320870,0,0,320870,0,
928400,Brittany Beauty School -,NY,320102,0,0,320102,0,
4164400,Angeles Institute,CA,319593,0,0,319593,0,
3803300,Healthcare Training Institute,NJ,319461,0,0,319461,0,
1161700,Center For Allied Health Education,NY,318982,0,0,318982,0,
4209300,Paul Mitchell The School Overland Park,KS,318952,0,0,318952,0,
2568500,Grabber School Of Hair Design,MO,318144,0,0,318144,0,
3065300,Paul Mitchell The School Bradley,IL,317512,0,0,317512,0,
3283300,Northwest Hvac/R Association & Training,WA,62732,92612,161000,316344,0,
3051900,Adler Graduate School,MN,53819,92142,170000,315961,0,
3371300,Toni&Guy Hairdressing Academy I Tigi Creative School,TX,313195,0,0,313195,0,
2066100,Ohio State College Of Barber Styling,OH,312642,0,0,312642,0,
933500,Mesivta Of Eastern Parkway Rabbinical Seminary,NY,60547,91870,160000,312417,0,
902900,Neighborhood Playhouse School Of The Theatre (The),NY,60982,86156,165000,312138,0,
2105900,Brittany Beauty Academy,NY,312065,0,0,312065,0,
4208900,Advanced Career Institute,CA,311065,0,0,311065,0,
1202600,Bellus Academy,CA,310881,0,0,310881,0,
4117600,Larry'S Barber College,IL,310874,0,0,310874,0,
3935300,California Nurses Educational Institute,CA,309864,0,0,309864,0,
2210800,Medina County Joint Vocational School,OH,38825,99016,172000,309841,0,
4215400,Grace School Of Theology,TX,32732,98060,177000,307792,0,
4155000,Northwest School Of Wooden Boat Building,WA,63564,79027,165000,307591,0,
1278300,Oswego County Boces,NY,125152,182318,0,307470,0,
4209200,South Dade Technical College-South Dade Skills Center Campus,FL,83362,223849,0,307211,0,
3746400,Southeastern Institute,SC,306951,0,0,306951,0,
4174100,Paul Mitchell The School Phoenix,AZ,306817,0,0,306817,0,
3785300,Cambridge Technical Institute,PR,306689,0,0,306689,0,
3837300,Aveda Fredric'S Institute,OH,306542,0,0,306542,0,
3907300,Paul Mitchell The School Great Lakes,MI,306375,0,0,306375,0,
4221400,Paul Mitchell The School Denver,CO,306368,0,0,306368,0,
970800,Eve'S College Of Hairstyling,OK,305703,0,0,305703,0,
1209000,Robert Fiance Beauty Schools,NJ,304898,0,0,304898,0,
3552300,Leston College,PR,304702,0,0,304702,0,
156000,Columbia Theological Seminary,GA,68698,82724,153000,304422,224956000,
4267000,Neo-Esthetique European Institute,PR,304166,0,0,304166,0,
4185100,Northeast Technical Institute,ME,303535,0,0,303535,0,
4147300,Tricoci University Of Beauty Culture,IL,303260,0,0,303260,0,
3425300,Rosedale Bible College,OH,54367,90756,158000,303123,0,
2586400,Trumbull Career And Technical Center-Adult Training Center,OH,112359,190643,0,303002,0,
3104000,Shawsheen Valley School Of Practical Nursing,MA,56964,83811,162000,302775,0,
2340800,Paul Mitchell The School Lexington,KY,302711,0,0,302711,0,
2239100,Central Texas Beauty College 2,TX,302581,0,0,302581,0,
4240500,Paul Mitchell The School Tulsa,OK,302285,0,0,302285,0,
4122000,Tri County Regional Vocational Technical High School,MA,61619,87360,153000,301979,0,
3939600,Daytona College,FL,301333,0,0,301333,0,
4203100,Paul Mitchell The School Reno,NV,300897,0,0,300897,0,
4177400,Capilo School Of Hair Design,ME,300391,0,0,300391,0,
3063400,Modern Technology School,CA,300190,0,0,300190,0,
1218700,Blackstone Valley Vocational Regional School District,MA,43819,93302,162000,299121,0,
2580200,Atlanta School Of Massage,GA,298408,0,0,298408,0,
2241700,Pj'S College Of Cosmetology,IN,297401,0,0,297401,0,
543800,Saline County Career Center,MO,52890,78106,166000,296996,0,
2056100,Four Rivers Career Center,MO,57399,87143,152000,296542,0,
4163200,Tenaj Salon Institute,FL,296389,0,0,296389,0,
4180600,Appalachian College Of Pharmacy,VA,61104,82299,152000,295403,0,
168200,Garrett - Evangelical Theological Seminary,IL,54902,84124,156000,295026,0,
4040300,Compass Career College,LA,294870,0,0,294870,0,
998900,California Aeronautical University,CA,294711,0,0,294711,0,
2498200,G Skin & Beauty Institute,IL,294614,0,0,294614,0,
3075200,Twin City Beauty College,MI,294015,0,0,294015,0,
205500,University Of Maine - Machias,ME,293556,0,0,293556,0,
4191900,Paul Mitchell The School Spokane,WA,293175,0,0,293175,0,
2482400,Ponce Health Sciences University,PR,292489,0,0,292489,0,
289000,Union Theological Seminary,NY,59416,81565,151000,291981,112560000,
4141300,San Francisco Institute Of Esthetics & Cosmetology,CA,291524,0,0,291524,0,
2523900,Elizabeth Grady School Of Esthetics And Massage Therapy,MA,291436,0,0,291436,0,
2084800,Ravenscroft Beauty College,IN,291246,0,0,291246,0,
4162400,Toni&Guy Hairdressing Academy,NM,290981,0,0,290981,0,
2568600,Mahoning County Career And Technical Center,OH,37149,86271,166000,289420,0,
4117700,"Monroe 2 - Orleans Boces, Center For Workforce Development",NY,92085,197197,0,289282,0,
4141200,Toni & Guy Hairdressing Academy,RI,289022,0,0,289022,0,
169800,John Marshall Law School (The),IL,288952,0,0,288952,0,
2258600,Avalon School Of Cosmetology,CA,288531,0,0,288531,0,
405600,North American Baptist Seminary,SD,37001,88162,163000,288163,0,
4117400,Milwaukee Career College,WI,288092,0,0,288092,0,
4237100,Salon Professional Academy (The),CA,287982,0,0,287982,0,
4197600,"Florida Institute Of Recording, Sound And Technology",FL,287242,0,0,287242,0,
3466400,Seattle School Of Theology And Psychology (The),WA,58777,80079,148000,286856,0,
4155900,Aveda Fredric'S Institute,IN,286480,0,0,286480,0,
3109500,Dongguk University Los Angeles,CA,60458,80008,146000,286466,0,
4131300,Corinth Academy Of Cosmetology,MS,286443,0,0,286443,0,
2514100,Takoda Institute Of Higher Education,MN,42315,87371,156000,285686,0,
2206300,Beauty Institute (The),PA,285213,0,0,285213,0,
3588300,Irene'S Myomassology Institute,MI,284945,0,0,284945,0,
3256300,Yeshiva Gedolah Rabbinical College,FL,55254,83524,146000,284778,0,
3654300,Eastern Virginia Career College,VA,284478,0,0,284478,0,
185800,Divine Word College,IA,52060,84341,148000,284401,0,
4140700,Aveda Institute Chapel Hill,NC,284390,0,0,284390,0,
3856500,Florida School Of Traditional Midwifery,FL,35271,90982,158000,284253,0,
4126000,Paul Mitchell The School Cleveland,OH,284158,0,0,284158,0,
2362300,Mercer County Career Center,PA,39531,82328,162000,283859,0,
4270300,Yeshivas Emek Hatorah,NJ,56454,82397,145000,283851,0,
3299300,Pacific College,CA,283666,0,0,283666,0,
3414500,Acupuncture And Massage College,FL,283101,0,0,283101,0,
2124400,University Of Spa & Cosmetology Arts,IL,281764,0,0,281764,0,
2285000,Paul Mitchell The School Huntsville,AL,280920,0,0,280920,0,
4241500,Wave Leadership College,VA,47516,84520,148000,280036,0,
3868400,Los Angeles College Of Music,CA,279751,0,0,279751,0,
1005500,Crawford County Career & Technical Center,PA,49853,67542,162000,279395,0,
2074400,Illinois Eastern Community Colleges -Frontier Community College,IL,279328,0,0,279328,0,
267400,New York Theological Seminary,NY,45974,81879,151000,278853,0,
555700,C H Mccann Technical School,MA,54800,81488,142000,278288,0,
4014300,P&A Scholars Beauty School,MI,278254,0,0,278254,0,
4153300,Paul Mitchell The School Columbus,OH,278089,0,0,278089,0,
3039900,Fremont College,CA,277847,0,0,277847,0,
2117800,Aveda Arts & Sciences Institute Lafayette,LA,277500,0,0,277500,0,
885900,John A Gupton College,TN,36947,87146,153000,277093,0,
1301000,Lancaster Beauty School,CA,276907,0,0,276907,0,
4218500,Innovate Salon Academy,NJ,276460,0,0,276460,0,
2112700,"North Haven Academy, Llc",CT,276333,0,0,276333,0,
4136400,American Institute Of Medical Sciences & Education,NJ,276285,0,0,276285,0,
4151600,My-Le'S Beauty College,LA,275942,0,0,275942,0,
2530700,Sebring Career Schools,TX,275383,0,0,275383,0,
2553000,Modern College Of Design (The),OH,274561,0,0,274561,0,
2220400,Catherine Hinds Institute Of Esthetics,MA,274119,0,0,274119,0,
4131600,Liberty Junior College,PR,274020,0,0,274020,0,
4219200,Ace Cosmetology & Barbering Training Center,CT,273453,0,0,273453,0,
4192100,American Medical Academy,FL,273262,0,0,273262,0,
2600500,Wes Watkins Technology Center School District #25,OK,87161,185876,0,273037,0,
2140400,St. Joseph Hospital Of Nashua N.H.D/B/A St. Joseph School Of Nursing,NH,96027,176727,0,272754,0,
3092600,Messenger College,TX,41759,84135,146000,271894,0,
4149200,Xcell Academy A Paul Mitchell School,AL,271411,0,0,271411,0,
4210300,Medspa Academies,UT,270463,0,0,270463,0,
2104300,Otsego Delaware Schoharie Greene Boces,NY,54054,78807,137000,269861,0,
2564700,Elaine Steven Beauty College,MO,269098,0,0,269098,0,
311300,Pontifical College Josephinum,OH,63175,73352,132000,268527,0,
3418300,Gwinnett College-Sandy Springs,GA,268254,0,0,268254,0,
3732300,Iyrs School Of Technology & Trades,RI,54919,66281,147000,268200,0,
1013000,Wade College,TX,268048,0,0,268048,0,
3035200,Tint School Of Makeup & Cosmetology,TX,267928,0,0,267928,0,
1090300,Rizzieri Aveda School For Beauty And Wellness,NJ,267582,0,0,267582,0,
246700,Conception Seminary College,MO,52627,77941,137000,267568,0,
3543300,Harris School Of Business,DE,267318,0,0,267318,0,
3458300,My Le'S Beauty College,CA,266867,0,0,266867,0,
1061800,Mid America College Of Funeral Service,IN,9117,93670,164000,266787,0,
2311000,Paul Mitchell The School Portland,OR,266631,0,0,266631,0,
3021500,Nuvani Institute,TX,266603,0,0,266603,0,
923200,Catholic Theological Union At Chicago,IL,47654,76643,142000,266297,0,
4147400,Tricoci University Of Beauty Culture,IL,265804,0,0,265804,0,
2343800,Montgomery Beauty School,MD,265117,0,0,265117,0,
4152200,Carthage R-9 School District/Carthage Technical Center,MO,96621,168356,0,264977,0,
3116400,Vanguard - Sentinel Joint Vocational School District,OH,39503,82013,142000,263516,0,
120700,Graduate Theological Union,CA,59068,71509,132000,262577,51475000,
4218900,Rocky Vista University,CO,262167,0,0,262167,0,
156800,Interdenominational Theological Center,GA,44417,76484,141000,261901,0,
3510300,Erikson Institute,IL,41187,77375,143000,261562,46655000,
1183000,Berk Trade & Business School,NY,261450,0,0,261450,0,
3670300,Toni&Guy Hairdressing Academy,CO,261110,0,0,261110,0,
3107000,Southwest College Of Naturopathic Medicine & Health Sciences,AZ,114934,145960,0,260894,0,
1293200,Tint School Of Makeup & Cosmetology,WA,260547,0,0,260547,0,
312200,United Theological Seminary,OH,80709,126438,53000,260147,0,
4223800,Electrical And Hvac/R Training Center,NY,259836,0,0,259836,0,
4092400,Make-Up Designory,CA,258613,0,0,258613,0,
2351700,Paul Mitchell The School - Louisville,KY,258448,0,0,258448,0,
2125000,Career Academy Of Beauty,CA,258413,0,0,258413,0,
543000,Poplar Bluff Technical Career Center,MO,50853,75842,131000,257695,0,
4122800,Presbyterian Theological Seminary In America,CA,41486,77487,138000,256973,0,
4162700,Eric Fisher Academy,KS,256675,0,0,256675,0,
4144800,International Academy Of Style,NV,256631,0,0,256631,0,
3098200,Yo San University Of Traditional Chinese Medicine,CA,59068,69405,128000,256473,0,
3535300,Huntingdon County Career And Technology Center,PA,45583,73381,137000,255964,0,
4221900,California Technical Academy,CA,255559,0,0,255559,0,
893800,Graham Hospital School Of Nursing,IL,39279,78903,137000,255182,0,
4181400,Best Care College,NJ,255167,0,0,255167,0,
3116600,East San Gabriel Valley Rop And Technical Center,CA,255012,0,0,255012,0,
215400,Hellenic College & Holy Cross Greek Orthodox School Of Theology,MA,111043,143030,0,254073,0,
3276300,Academy Of Hair Design,TX,253226,0,0,253226,0,
758800,Capri College,IA,253210,0,0,253210,0,
4227100,America Evangelical University,CA,33544,79214,140000,252758,0,
4175900,Geisinger-Lewistown Hospital School Of Nursing,PA,32817,79881,140000,252698,0,
2090300,Capri College,IA,252527,0,0,252527,0,
4146800,South Texas Training Center,TX,252140,0,0,252140,0,
528900,Waynesville Career Center,MO,53380,70502,128000,251882,0,
956700,Tennessee School Of Beauty,TN,251557,0,0,251557,0,
2142200,Lex La Ray Technical Center,MO,44826,74849,131000,250675,0,
3005100,Arkansas Beauty School- Little Rock,AR,250493,0,0,250493,0,
3023400,Arkansas College Of Barbering & Hair Design,AR,249875,0,0,249875,0,
2275000,Jenny Lea Academy Of Cosmetology,TN,249743,0,0,249743,0,
2079700,College Of Hair Design,NE,249536,0,0,249536,0,
1159600,Sylvain Melloul International Hair Academy,VA,248788,0,0,248788,0,
2282100,"High Plains Technology Center, School District No. 24",OK,54421,194173,0,248594,0,
2198900,Michigan School Of Psychology,MI,43937,71594,132000,247531,0,
3478400,Phoenix Seminary,AZ,42117,71977,133000,247094,0,
761700,Carnegie Institute,MI,246994,0,0,246994,0,
1042400,Summit Salon Academy,KY,246137,0,0,246137,0,
4177300,Ohio Medical Career College,OH,246076,0,0,246076,0,
3985300,Cda Technical Institute,FL,245723,0,0,245723,0,
973900,Glen Dow Academy Of Hair Design & Salons,WA,245537,0,0,245537,0,
4041300,Berks Career & Technology Center,PA,35466,76488,133000,244954,0,
4174800,American Trade School,MO,244354,0,0,244354,0,
2323000,Missio Theological Seminary,PA,45643,69688,129000,244331,0,
4226400,Mt Training Center,TX,244174,0,0,244174,0,
2575400,International Culinary Center,NY,244131,0,0,244131,0,
915700,Wyotech,WY,243773,0,0,243773,0,
2285100,Hilltop Beauty School,CA,243264,0,0,243264,0,
1170300,Penta County Vocational School,OH,39934,74315,129000,243249,0,
2553500,Associated Technical College,CA,243114,0,0,243114,0,
4235900,Bella Cosmetology And Barber College,TX,242664,0,0,242664,0,
1290400,Monongalia County Technical Education Center (Mtec),WV,93681,148572,0,242253,0,
2153600,Broome Delaware Tioga Boces Program Of Practical Nursing,NY,94163,147601,0,241764,0,
1229700,Laredo Beauty College,TX,241660,0,0,241660,0,
3332300,Southern California Seminary,CA,39208,73395,129000,241603,0,
2543400,Brownson Technical School,CA,241003,0,0,241003,0,
138900,Holy Apostles College & Seminary,CT,22522,78426,140000,240948,0,
4155300,Onondaga School Of Therapeutic Massage,NY,240765,0,0,240765,0,
2491500,Southwest University Of Visual Arts,AZ,239538,0,0,239538,0,
4211900,Xavier College School Of Nursing,CA,238863,0,0,238863,0,
4184200,Taylor Andrews Academy-St. George,UT,238549,0,0,238549,0,
4242000,Latin Beauty Academy,FL,238057,0,0,238057,0,
4160400,Angeles College,CA,237819,0,,237819,0,
4172700,Salon Professional Academy (The),IN,237818,0,0,237818,0,
4174500,Aveda Institute Of New Mexico (The),NM,237641,0,0,237641,0,
2242400,Henrico County-Saint Mary'S Hospital School Of Practical Nursing,VA,110429,127210,0,237639,0,
1186500,California Hair Design Academy,CA,237120,0,0,237120,0,
4204700,Paul Mitchell The School Raleigh,NC,237073,0,0,237073,0,
4175100,Paul Mitchell The School Honolulu,HI,237042,0,0,237042,0,
4092300,Coastline Beauty College,CA,236995,0,0,236995,0,
2497800,Greene County Career Center,OH,37198,72515,127000,236713,0,
3735400,"Charlie'S Guard, Detective Bureau, And Academy",PR,236171,0,0,236171,0,
884300,Alaska Bible College,AK,42068,70715,123000,235783,0,
4166000,Manhattan Institute (The),NY,235112,0,0,235112,0,
2562500,International Technical College,PR,234857,0,0,234857,0,
967300,Rudae'S School Of Beauty Culture,IN,234658,0,0,234658,0,
3067600,Raphael'S School Of Beauty Culture,OH,234526,0,0,234526,0,
3827300,Charlotte Christian College And Theological Seminary,NC,32851,73494,128000,234345,0,
2573200,La Belle Beauty Academy,FL,234070,0,0,234070,0,
4115300,Coachella Valley Beauty College,CA,233574,0,0,233574,0,
727600,Saint Meinrad School Of Theology,IN,40897,67572,125000,233469,0,
1298400,Professional Institute Of Beauty,CA,233396,0,0,233396,0,
1300700,Nazarene Bible College,CO,5757,82244,145000,233001,0,
807500,St. John Vianney College Seminary,FL,38046,70351,124000,232397,0,
4266000,Bais Medrash Mayan Hatorah,NJ,46377,66870,119000,232247,0,
3010700,Paul Mitchell The School Roanoke,VA,232095,0,0,232095,0,
2361300,The Landing School Of Boatbuilding & Design,ME,43850,67707,120000,231557,0,
4203300,Aveda Institute Des Moines,IA,231383,0,0,231383,0,
4104300,Academy Di Capelli,CT,230964,0,0,230964,0,
3463300,Careers Unlimited,UT,230510,0,0,230510,0,
2320800,Magnolia College Of Cosmetology,MS,229881,0,0,229881,0,
2595600,Asian-American International Beauty College,CA,229596,0,0,229596,0,
4144200,Career Development Institute,CA,228785,0,0,228785,0,
961700,Capitol School Of Hairstyling And Esthetics,NE,228346,0,0,228346,0,
4105400,Pensacola School Of Massage Therapy & Health Careers,FL,228149,0,0,228149,0,
1014000,Mineral County Vocational Technical Center,WV,40808,68137,119000,227945,0,
2603100,Crave Beauty Academy,KS,227937,0,0,227937,0,
1013800,Stewart School,SD,227595,0,0,227595,0,
4076400,Gnomon,CA,226588,0,0,226588,0,
4250400,Fosbre Academy Of Hair Design,WA,226584,0,0,226584,0,
3081900,Yti Career Institute - Altoona,PA,225942,0,0,225942,0,
713000,Newberry School Of Beauty,CA,225726,0,0,225726,0,
3125300,John Wesley International Barber And Beauty College,CA,225673,0,0,225673,0,
335600,Pittsburgh Theological Seminary,PA,40736,64694,120000,225430,0,
3288300,Academy Of Chinese Culture And Health Sciences,CA,49465,61806,114000,225271,0,
4155100,Institute Of Medical And Business Careers,PA,225111,0,0,225111,0,
2184400,Jenks Beauty College,OK,224888,0,0,224888,0,
176500,University Of Saint Mary Of The Lake,IL,43064,63728,118000,224792,0,
3557300,North Florida Cosmetology Institute,FL,224742,0,0,224742,0,
4130400,Shear Excellence Hair Academy,FL,224489,0,0,224489,0,
4163000,Summit Salon Academy,FL,224446,0,0,224446,0,
2593700,Richport Technical College,PR,223803,0,0,223803,0,
2134800,Old Town Barber College,KS,223567,0,0,223567,0,
3766300,Cortiva Institute,PA,223392,0,0,223392,0,
4193200,Rocky Mountain University Of Health Professions,UT,223276,0,0,223276,0,
2211900,Cheeks Beauty Academy,WY,223185,0,0,223185,0,
2318200,Kd Conservatory College Of Film And Dramatic Arts,TX,223164,0,0,223164,0,
771700,Capri College,IA,222923,0,0,222923,0,
989800,Avery James School Of Cosmetology,LA,222638,0,0,222638,0,
1313400,Yeshivath Beth Moshe,PA,44687,64944,113000,222631,0,
4276000,Glitz School Of Cosmetology,NM,222535,0,0,222535,0,
4223700,Bay Area Medical Academy,CA,222337,0,0,222337,0,
1307400,American Beauty College,CA,221903,0,0,221903,0,
4249000,Medical Career And Technical College,KY,221558,0,0,221558,0,
4206200,Digital Film Academy,NY,221487,0,0,221487,0,
225400,Michigan State University College Of Law,MI,221124,0,0,221124,0,
462100,Ayers Career College,LA,220509,0,0,220509,0,
4100300,Denmark College,IN,219869,0,0,219869,0,
4235400,Saint Michael College Of Allied Health,VA,219720,0,0,219720,0,
4213500,Sharp Edgez Barber Institute,NY,219572,0,0,219572,0,
1102600,Warrensburg Area Career Center,MO,46106,63356,110000,219462,0,
4178200,Vogue College - San Antonio,TX,219075,0,0,219075,0,
326300,Evangelical Theological Seminary,PA,20659,42286,156000,218945,0,
4114400,Institute Of World Politics (The),DC,37536,63272,117000,217808,0,
4188300,Florida Academy,FL,217593,0,0,217593,0,
3682400,Dallas Barber & Stylist College,TX,217481,0,0,217481,0,
359500,Oblate School Of Theology,TX,39831,62182,115000,217013,0,
2537200,Palomar Institute Of Cosmetology,CA,216046,0,0,216046,0,
2600000,"Northwest Technology Center, School District 10",OK,85786,130181,0,215967,0,
4130200,Institute Of Production And Recording (The),MN,215678,0,0,215678,0,
221400,Saint John'S Seminary,MA,50920,57709,107000,215629,0,
855200,Stevens - The Institute Of Business & Arts,MO,214565,0,0,214565,0,
2152000,Yeshiva Shaar Hatorah,NY,43952,61551,109000,214503,0,
4152400,International Institute Of Cosmetology,CT,214064,0,0,214064,0,
2297800,Headlines Academy,SD,213757,0,0,213757,0,
1174900,Wood County Technical Center,WV,37341,64175,112000,213516,0,
2520400,Adrians Beauty College Of Turlock,CA,213440,0,0,213440,0,
760000,International Beauty School,WV,213159,0,0,213159,0,
2122000,New England Hair Academy,MA,213149,0,0,213149,0,
4145400,Oxford Academy Of Hair Design,CT,212940,0,0,212940,0,
2363500,Arthur'S Beauty College,AR,212858,0,0,212858,0,
3963300,Institute Of Health And Technology,MS,212413,0,0,212413,0,
2500000,San Joaquin College Of Law,CA,42482,59275,110000,211757,0,
2234600,Atlantic Beauty & Spa Academy,NJ,211628,0,0,211628,0,
1094300,Rabbinical College Beth Shraga,NY,43268,61178,107000,211446,0,
4215100,California Career Institute,CA,211121,0,0,211121,0,
864500,Empire Beauty Schools,NH,211058,0,0,211058,0,
2504500,Mayagüez Institute Of Technology,PR,210943,0,0,210943,0,
825900,Educators Of Beauty College Of Cosmetology,IL,210787,0,0,210787,0,
4184000,Paul Mitchell The School Indianapolis,IN,210143,0,0,210143,0,
172100,Mccormick Theological Seminary,IL,32880,62124,115000,210004,78025000,
3891300,Soma Institute - The National School Of Clinical Massage Therapy,IL,209436,0,0,209436,0,
4120900,Arizona Culinary Institute,AZ,209341,0,0,209341,0,
1052900,Memphis Theological Seminary,TN,36663,60641,112000,209304,0,
3433400,New Concept Massage & Beauty School,FL,209257,0,0,209257,0,
2244300,Mississippi Barber Academy,MS,209055,0,0,209055,0,
3077200,Paul Mitchell The School Missouri Columbia,MO,208917,0,0,208917,0,
4229800,Gadsden Technical Institute,FL,41133,60783,107000,208916,0,
2257700,Hays Academy Of Hair Design,KS,208816,0,0,208816,0,
4125400,Paul Mitchell The School Austin,TX,208605,0,0,208605,0,
1226800,Baldwin Beauty Schools,TX,208482,0,0,208482,0,
2578000,Santa Barbara Business College,CA,208381,0,0,208381,0,
4228300,Paul Mitchell The School Schenectady,NY,207766,0,0,207766,0,
2074900,Chris' Beauty College,MS,206812,0,0,206812,0,
4274900,Contra Costa Medical Career College,CA,206180,0,0,206180,0,
4165000,Meridian Institute Of Surgical Assisting,TN,205301,0,0,205301,0,
3126800,Pacifica Graduate Institute,CA,204263,0,0,204263,0,
4145500,Skin Science Institute Of Laser & Esthetics,UT,204214,0,0,204214,0,
2539800,Queen City College,TN,203636,0,0,203636,0,
4185000,Colorado Academy Of Veterinary Technology,CO,203310,0,0,203310,0,
2257900,International Academy,FL,203011,0,0,203011,0,
2600200,Ocean Corporation (The),TX,203004,0,0,203004,0,
3921300,Cameo College Of Essential Beauty,UT,202759,0,0,202759,0,
3361300,Gwinnett College,NC,202040,0,,202040,0,
3559300,Appalachian School Of Law,VA,41609,56349,104000,201958,0,
3909300,Paul Mitchell The School Logan,UT,201857,0,0,201857,0,
4183100,Washington Barber College,AR,201847,0,0,201847,0,
1085100,Branford Hall Career Institute,NJ,201705,0,0,201705,0,
4251300,Pacific Bible College,OR,23644,64530,113000,201174,0,
2144000,Beauty Institute (The),PA,201004,0,0,201004,0,
4160600,Paul Mitchell The School Normal,IL,200795,0,0,200795,0,
4175400,Elite Cosmetology School,CA,200776,0,0,200776,0,
3106900,Escuela De Peritos Electricistas De Isabela,PR,200249,0,0,200249,0,
4165300,Paul Mitchell The School Milwaukee,WI,200128,0,0,200128,0,
655100,St Margaret Memorial Hospital School Of Nursing,PA,91302,108816,0,200118,0,
4189600,State Career School,IL,199410,0,0,199410,0,
4242500,Associated Barber College Of San Diego,CA,199340,0,0,199340,0,
4249600,Westcliff University,CA,199036,0,0,199036,0,
2237500,Las Vegas College,NV,198868,0,0,198868,0,
2190400,Schilling - Douglas School Of Hair Design,DE,198790,0,0,198790,0,
1148400,Advanced Institute Of Hair Design,WI,198701,0,0,198701,0,
4159700,American Medical Sciences Center,CA,198625,0,0,198625,0,
1288100,Montachusett Regional Vocational Technical School,MA,32693,60501,105000,198194,0,
4238400,Florida International Training Institute,FL,197885,0,0,197885,0,
4228900,Mcdougle Technical Institute,FL,197728,0,0,197728,0,
1308800,Capri Oak Forest Beauty College,IL,197482,0,0,197482,0,
4234800,Randolph Technical Center,WV,36561,55493,105000,197054,0,
4089400,Cci Training Center,TX,196861,0,0,196861,0,
197400,Louisville Presbyterian Theological Seminary,KY,45392,53158,98000,196550,0,
135400,Iliff School Of Theology,CO,39110,55176,102000,196286,0,
4043300,Ace Institute Of Technology,NY,196165,0,0,196165,0,
374300,Union Presbyterian Seminary,VA,41609,54003,100000,195612,0,
3987300,Texas Health School,TX,195533,0,0,195533,0,
818900,Continental School Of Beauty Culture,NY,195501,0,0,195501,0,
4154800,Duvall'S School Of Cosmetology,TX,195388,0,0,195388,0,
2289700,Jolie Health And Beauty Academy,PA,195046,0,0,195046,0,
4184700,Protege Academy,MI,194895,0,0,194895,0,
2607000,Tricoci University Of Beauty Culture,IN,194660,0,0,194660,0,
4262900,Western Michigan University Homer Stryker M.D. School Of Medicine,MI,78563,115890,0,194453,0,
3030900,Diesel Driving Academy,LA,194253,0,0,194253,0,
4068300,Four County Career Center,OH,18106,61957,114000,194063,0,
4260200,"Elite Cosmetology, Barber & Spa Academy",WA,193873,0,0,193873,0,
2287100,La Belle Beauty School,FL,193530,0,0,193530,0,
738700,Long Island Beauty School,NY,192494,0,0,192494,0,
2606300,Paul Mitchell The School Wichita,KS,191805,0,0,191805,0,
4173800,Salon Professional Academy (The),CO,191082,0,0,191082,0,
3074500,East West College Of The Healing Arts,OR,191055,0,0,191055,0,
4230200,Paul Mitchell The School Farmington Hills,MI,190962,0,0,190962,0,
2565000,Platt Technical High School,CT,32573,49006,109000,190579,0,
3125600,Miami Ad School,FL,190523,0,0,190523,0,
4217000,Healthcare Training Institute,LA,190122,0,0,190122,0,
2358600,Stage One-The Hair School,LA,189917,0,0,189917,0,
1171500,Joseph F. Mccloskey School Of Nursing At Schuylkill Health,PA,82249,107659,0,189908,0,
4114500,Valley College Of Medical Careers,CA,189724,0,0,189724,0,
3414300,Monteclaro: Escuela De Hoteleria Y Artes Culinarias,PR,36831,55884,97000,189715,0,
907800,Capri Institute Of Hair Design,NJ,189299,0,0,189299,0,
4126900,Academy Of Career Training,FL,189286,0,0,189286,0,
757800,Huntington School Of Beauty Culture,WV,189254,0,0,189254,0,
2211000,Salon Success Academy,CA,189064,0,0,189064,0,
4234300,Culinary Tech Center,NY,188968,0,0,188968,0,
4145600,International College Of Cosmetology,CA,188961,0,0,188961,0,
2518300,Lasalle Tech,LA,188850,0,0,188850,0,
4165800,Salon Professional Academy (The),TX,188637,0,0,188637,0,
2339600,Rogers Academy Of Hair Design,IN,188446,0,0,188446,0,
4187700,Crevier'S School Of Cosmetology,MT,188300,0,0,188300,0,
4166700,Summit Salon Academy,IN,187777,0,0,187777,0,
3117000,Ashland County - West Holmes Career Center - Adult Education,OH,76818,110664,0,187482,0,
2304300,Platt College - San Diego,CA,187377,0,0,187377,0,
1294200,Rosemead Beauty School,CA,187022,0,0,187022,0,
2331000,Maryland Beauty Academy Of Essex,MD,186678,0,0,186678,0,
4208100,Ukiah Adult School,CA,49598,49975,87000,186573,0,
2199700,Heritage Christian University,AL,25804,58456,102000,186260,0,
1157200,Colorado School Of Trades,CO,186092,0,0,186092,0,
4264500,Yeshiva Ohr Naftoli,NY,38357,53706,94000,186063,0,
3903400,American Beauty School,NY,186006,0,0,186006,0,
4170100,Summit Salon Academy,WA,185557,0,0,185557,0,
189700,Wartburg Theological Seminary,IA,34289,53189,98000,185478,0,
4270000,Urban Barber College,CA,185408,0,0,185408,0,
4036300,Southeast Texas Career Institute,TX,185252,0,0,185252,0,
4207000,School Of Missionary Aviation Technology,MI,32257,53894,99000,185151,0,
2132800,National Conservatory Of Dramatic Arts,DC,40522,52603,92000,185125,0,
4178700,Atelier Esthetique Institute Of Esthetics,NY,184855,0,0,184855,0,
2306700,Fort Worth Beauty School,TX,184574,0,0,184574,0,
1040600,"Josef'S School Of Hair, Skin & Body",ND,184384,0,0,184384,0,
2125500,Circle In The Square Theatre School,NY,41430,51823,91000,184253,0,
987300,Aveda Institute Twin Falls,ID,184189,0,0,184189,0,
4141700,Healing Hands School Of Holistic Health,CA,183798,0,0,183798,0,
1181000,Taylor Business Institute,IL,183531,0,0,183531,0,
3513500,Williamson Christian College,TN,32878,54341,96000,183219,0,
3787300,Expertise Cosmetology Institute,NV,183021,0,0,183021,0,
2276800,Westminster Theological Seminary In California,CA,35790,51530,95000,182320,0,
1116600,Broadview University,UT,182258,0,0,182258,0,
2600100,New York Academy Of Art (The),NY,39863,50025,92000,181888,0,
4250000,Union Bible College,IN,34343,53329,94000,181672,0,
4059300,Tucson College Of Beauty,AZ,180991,0,0,180991,0,
822300,St. Vincent De Paul Regional Seminary,FL,40445,49286,91000,180731,0,
4224100,Cosmetology Academy Of Texarkana,TX,180042,0,0,180042,0,
3102100,Morgantown Beauty College,WV,179773,0,0,179773,0,
307500,Methodist Theological School In Ohio,OH,37536,50007,92000,179543,0,
3128500,National Latino Education Institute,IL,40882,50379,88000,179261,0,
2494700,Baltimore Studio Of Hair Design,MD,179166,0,0,179166,0,
989900,Lowell Academy Hair Styling Institute,MA,178641,0,0,178641,0,
354400,Austin Presbyterian Theological Seminary,TX,34917,50503,93000,178420,127642000,
4158400,L'Esprit Academy,MI,178333,0,0,178333,0,
224800,Cranbrook Academy Of Art,MI,41027,48193,89000,178220,0,
4131200,Total Image Beauty Academy,NJ,178161,0,0,178161,0,
4189100,Salon Institute - Toledo Campus,OH,177967,0,0,177967,0,
4175000,Universal Spa Training Academy,IL,177669,0,0,177669,0,
290000,Webb Institute,NY,41119,48367,88000,177486,66556000,
4220500,Butte County Regional Occupational Program,CA,60515,116551,0,177066,0,
4142000,Austin'S Beauty College,TN,177047,0,0,177047,0,
2560000,Casal Aveda Institute,OH,176993,0,0,176993,0,
2499000,Academy Of Cosmetology,FL,176007,0,0,176007,0,
1028000,Ohio State Beauty Academy,OH,175286,0,0,175286,0,
2612700,"Salon Professional Academy - Melbourne, The",FL,175281,0,0,175281,0,
4250500,National Personal Training Institute,FL,175113,0,0,175113,0,
1287900,Pat Goins Benton Road Beauty School,LA,175113,0,0,175113,0,
2269700,Aveda Institute Maryland,MD,174174,0,0,174174,0,
1096300,Greene County Career & Technology Center,PA,29535,52623,92000,174158,0,
4157100,L3 Commercial Training Solutions Airline Academy,FL,173310,0,0,173310,0,
3874300,Cambridge Junior College,CA,172968,0,0,172968,0,
2212700,Lancaster School Of Cosmetology & Therapeutic Bodywork,PA,172624,0,0,172624,0,
777900,Lansdale School Of Business,PA,172490,0,0,172490,0,
3839300,Aveda Institute New York,NY,172354,0,0,172354,0,
3099600,"Mercy Hospital School Of Practical Nursing, A Program Of Plantation Ge",FL,172183,0,0,172183,0,
4183400,Salon Professional Academy (The),AR,172010,0,0,172010,0,
4060300,American Institute Of Medical Technology,OK,171804,0,0,171804,0,
4096300,Charleston School Of Law,SC,171674,0,0,171674,0,
4072300,Aveda Institute Provo,UT,171492,0,0,171492,0,
4190800,Santa Ana Beauty College,CA,171120,0,0,171120,0,
2205000,College Of Wilmington,NC,170909,0,0,170909,0,
4176000,American Technical Institute,PR,170856,0,0,170856,0,
2137100,Black Hills Beauty College,SD,170310,0,0,170310,0,
178900,Christian Theological Seminary,IN,31256,48815,90000,170071,0,
4274300,Caris College,IN,169712,0,0,169712,0,
4183300,Abcott Institute,MI,169653,0,0,169653,0,
2588600,Seminario Evangelico De Puerto Rico,PR,29679,48961,91000,169640,0,
826000,Iowa School Of Beauty,IA,169529,0,0,169529,0,
2181600,Rob Roy Academy,MA,168757,0,0,168757,0,
3910400,National Polytechnic College,CA,168452,0,0,168452,0,
4270400,Transitions Career Institute School Of Nursing,NY,167929,0,0,167929,0,
1321400,Roxborough Memorial Hospital,PA,167758,0,0,167758,0,
4001300,Palace Beauty College,CA,167681,0,0,167681,0,
2184200,Paroba College Of Cosmetology,WA,167414,0,0,167414,0,
3445300,Hds Truck Driving Institute,AZ,167052,0,0,167052,0,
215700,Hebrew College,MA,32876,47086,87000,166962,0,
2282300,Alhambra Beauty College,CA,166902,0,0,166902,0,
4121100,Elevate Salon Institute,MI,166435,0,0,166435,0,
4235500,Presidio Graduate School,CA,38408,44860,83000,166268,0,
3974500,California Career College,CA,166258,0,0,166258,0,
3051100,Chisholm Trail Technology Center School District No. 26,OK,52640,113567,0,166207,0,
1324000,Lytle'S Redwood Empire Beauty College,CA,166160,0,0,166160,0,
2359300,Shasta Bible College And Graduate School,CA,26199,50945,89000,166144,0,
2299300,Trinity Episcopal School For Ministry,PA,27473,48571,90000,166044,0,
4203500,Austin Kade Academy,ID,165658,0,0,165658,0,
1083600,Pivot Point Academy,IL,165647,0,0,165647,0,
4254000,Phipps Academy Of Barbering,IL,165608,0,0,165608,0,
4171100,Paul Mitchell The School - Delaware,DE,165470,0,0,165470,0,
4151200,Salon Professional Academy (The),NY,165215,0,0,165215,0,
4210800,Nri Institute Of Health Sciences,FL,163872,0,0,163872,0,
2139500,Hawaii Institute Of Hair Design,HI,163841,0,0,163841,0,
4233100,Arizona School Of Integrative Studies,AZ,163548,0,0,163548,0,
4205500,Lil Lou'S Beauty And Barber College Llc,IN,163493,0,0,163493,0,
792100,Paul Mitchell The School Arkansas,AR,163392,0,0,163392,0,
4185600,Medical Allied Career Center,CA,163365,0,0,163365,0,
2331200,Baptist Missionary Association Theological Seminary,TX,20831,51368,91000,163199,0,
4124700,Ambria College Of Nursing,IL,162885,0,0,162885,0,
4186900,"International College Of Beauty, Arts & Sciences",CA,162618,0,0,162618,0,
350700,Memphis College Of Art,TN,162346,0,0,162346,0,
4273300,Victory Career College,CA,162289,0,0,162289,0,
4158500,Texas Beauty College,TX,162091,0,0,162091,0,
4192400,Yeshiva Gedolah Zichron Leyma,NJ,31665,47403,83000,162068,0,
4216000,Universal Training Institute,NJ,162039,0,0,162039,0,
4138500,Houston International College Cardiotech Ultrasound School,TX,161545,0,0,161545,0,
4256500,Baldy View Regional Occupational Program,CA,61625,99194,0,160819,0,
4157600,Nova Academy Of Cosmetology,MN,160801,0,0,160801,0,
4187200,New Beginning College Of Cosmetology,AL,160764,0,0,160764,0,
3663300,Hood Theological Seminary,NC,31336,45372,84000,160708,0,
2569600,Searcy Beauty College,AR,159333,0,0,159333,0,
2313000,Cass Career Center,MO,37739,44056,77000,158795,0,
4245500,Universal Healthcare Careers College,CA,158672,0,0,158672,0,
1235900,B M Spurr School Of Practical Nursing,WV,31232,46255,81000,158487,0,
656000,Ohio Valley General Hospital School Of Nursing,PA,21308,49080,88000,158388,0,
2260200,Diesel Driving Academy,LA,158043,0,0,158043,0,
247600,Kenrick - Glennon Seminary,MO,29970,45065,83000,158035,0,
4159600,Galaxy Medical College,CA,157375,0,0,157375,0,
246200,Eden Theological Seminary,MO,31134,44241,82000,157375,0,
2324500,Michigan College Of Beauty-Monroe,MI,157293,0,0,157293,0,
3097800,Carsten Institute Of Cosmetology,NY,157005,0,0,157005,0,
4237800,California Barber And Beauty College,CA,156711,0,0,156711,0,
4192700,Barber School (The) By Tim Hite,UT,156033,0,0,156033,0,
4195200,Diamond Beauty College,CA,155896,0,0,155896,0,
4237700,Regional Center For Border Health,AZ,13967,49729,92000,155696,0,
4179900,Tomorrow'S Image Barber & Beauty Academy Of Virginia,VA,155646,0,0,155646,0,
4170600,Salon Professional Academy (The),MO,155262,0,0,155262,0,
4169900,American Beauty Academy,UT,155076,0,0,155076,0,
4212000,Lawrence & Company College Of Cosmetology,CA,154888,0,0,154888,0,
3475400,Tri-State Bible College,OH,25800,46738,82000,154538,0,
2528200,Robert Fiance Beauty Schools,NJ,154526,0,0,154526,0,
2520000,International School Of Skin And Nailcare,GA,154203,0,0,154203,0,
4218400,City Pointe Beauty Academy,MO,153715,0,0,153715,0,
718700,North Adrian'S College Of Beauty,CA,153436,0,0,153436,0,
4230500,Paul Mitchell The School Grand Rapids,MI,153424,0,0,153424,0,
3012300,Asm Beauty World Academy,FL,153271,0,0,153271,0,
4164100,Montana Academy Of Salons,MT,152333,0,0,152333,0,
2262100,Hair Professionals School Of Cosmetology,IL,152298,0,0,152298,0,
1280300,Dominican House Of Studies,DC,30552,42675,79000,152227,0,
4157700,Salon Professional Academy (The),WI,152081,0,0,152081,0,
4276300,American Massage & Bodywork Institute,VA,151958,0,0,151958,0,
2178200,Charleston School Of Beauty Culture,WV,151472,0,0,151472,0,
2538500,Arthur'S Beauty College,AR,151409,0,0,151409,0,
3763400,Bold Beauty Academy,MT,151384,0,0,151384,0,
2582200,"Guy'S Academy Hair, Skin & Nails",LA,151266,0,0,151266,0,
2256200,Broken Arrow Beauty College,OK,150425,0,0,150425,0,
2622900,Rabbinical College Of Yeshiva And Kolel Bais Medrosh Elyon Association,NY,60982,89412,0,150394,0,
4178300,Vogue College Of Cosmetology,TX,150129,0,0,150129,0,
3205400,Jolie Hair And Beauty Academy,MA,150088,0,0,150088,0,
4169100,Diamonds Cosmetology College,TX,149983,0,0,149983,0,
1313200,International College Of Broadcasting,OH,149705,0,0,149705,0,
2298000,Design Institute Of San Diego,CA,149639,0,0,149639,0,
4120400,Paul Mitchell The School Miami,FL,149326,0,0,149326,0,
4183600,Salon Professional Academy Of Kenosha (The),WI,149246,0,0,149246,0,
2179600,Empire Beauty Schools,NH,149165,0,0,149165,0,
737500,Island Drafting & Technical Institute,NY,149013,0,0,149013,0,
2554500,Hazleton Area Career Center,PA,33666,42190,73000,148856,0,
4169000,Salon & Spa Institute,TX,148644,0,0,148644,0,
4153000,Renaissance Academie,UT,148303,0,0,148303,0,
2321400,Toni & Guy Hairdressing Academy,GA,147974,0,0,147974,0,
2178700,Citrus Heights Beauty College,CA,147682,0,0,147682,0,
4251000,Inter American University Of Puerto Rico - School Of Optometry,PR,66924,80734,0,147658,0,
2166000,Centro De Estudios Avanzados De Puerto Rico Y El Caribe,PR,36954,110226,0,147180,0,
173600,Northern Baptist Theological Seminary,IL,16994,45653,84000,146647,0,
4150900,Keune Academy By 124,GA,146504,0,0,146504,0,
4127200,Victoria'S Academy Of Cosmetology,WA,146462,0,0,146462,0,
4270800,Suncoast Technical Education Center,FL,17940,46513,82000,146453,0,
3479300,Pci College,CA,146325,0,0,146325,0,
3194300,Boston Graduate School Of Psychoanalysis,MA,25606,42390,78000,145996,0,
4128000,Millennium Training Institute,MA,145817,0,0,145817,0,
4189200,Salon Professional Academy (The),IL,145367,0,0,145367,0,
714200,Lyle'S College Of Beauty,CA,145271,0,0,145271,0,
2525900,Artistic Academy Of Hair Design (The),NJ,144984,0,0,144984,0,
4116400,Future-Tech Institute,FL,144916,0,0,144916,0,
4182100,First Class Cosmetology School,WI,144868,0,0,144868,0,
4260500,Digital Media Institute At Intertech,LA,19224,45578,80000,144802,0,
2275900,Modern Welding School,NY,143813,0,0,143813,0,
4223100,Arrojo Cosmetology School,NY,143683,0,0,143683,0,
2541900,Bj'S Beauty & Barber College,WA,143520,0,0,143520,0,
4246300,Edumed Partners,TN,143284,0,0,143284,0,
3734300,John D. Rockefeller Iv Career Center,WV,15141,46804,81000,142945,0,
2165200,Salon Professional Academy (The),CO,142706,0,0,142706,0,
4210700,New York Institute Of Beauty,NY,142667,0,0,142667,0,
4205100,Great Lakes Truck Driving School,OH,142439,0,0,142439,0,
4220400,Chrysm Institute Of Esthetics (The),VA,142024,0,0,142024,0,
4221100,New Horizons Medical Institute,GA,141871,0,0,141871,0,
4218200,Paul Mitchell The School - Jersey Shore,NJ,141637,0,0,141637,0,
4230900,Ricci'S Toni & Guy Hairdressing Academy/ Tigi Creative School,CT,141397,0,0,141397,0,
233100,Western Theological Seminary,MI,24397,40937,76000,141334,0,
2078000,Sacred Heart Seminary And School Of Theology,WI,28515,39714,73000,141229,0,
1016100,Loraines Academy & Spa,FL,141007,0,0,141007,0,
3263300,Traxler'S School Of Hair,MS,140747,0,0,140747,0,
4163100,Summit Salon Academy - Gainesville,FL,140570,0,0,140570,0,
1044100,Pardee Rand Graduate School,CA,29679,38823,72000,140502,0,
1289600,"North Coast College, The",OH,140180,0,0,140180,0,
4231200,Neecee'S Barber College,TX,139821,0,0,139821,0,
3430300,Universal Therapeutic Massage Institute,NM,139681,0,0,139681,0,
4225500,Westchester School For Dental Assistants,NY,139681,0,0,139681,0,
4215200,Vibe Barber College,TN,139552,0,0,139552,0,
4216900,San Ignacio University,FL,139442,0,0,139442,0,
4252300,Premier Barber Institute,PA,139299,0,0,139299,0,
4195500,Southern States University,CA,139085,0,0,139085,0,
4141000,Douglas J Aveda Institute-Chicago,IL,138888,0,0,138888,0,
2602100,Northwest College Of Art & Design,WA,138482,0,0,138482,0,
4225000,Parisian Spa Institute,FL,138096,0,0,138096,0,
1001700,Payne Theological Seminary,OH,25666,39396,73000,138062,0,
3823300,Florida Academy Of Health & Beauty,FL,137965,0,0,137965,0,
4220000,Designer Barber & Stylist School,AR,137801,0,0,137801,0,
1274400,Southside College Of Health Sciences,VA,137088,0,0,137088,0,
4224400,Networks Barber College,IL,136724,0,0,136724,0,
3011800,Ucas University Of Cosmetology Arts & Sciences,TX,136263,0,0,136263,0,
4174900,Estelle International,IL,136220,0,0,136220,0,
4130600,Healing Arts Center,MO,136151,0,0,136151,0,
3970300,Hands On Therapy,TX,135777,0,0,135777,0,
4148500,Medical Institute Of Palm Beach,FL,135341,0,0,135341,0,
369000,Marlboro College,VT,135285,0,0,135285,0,
4158300,Flagler Technical Institute,FL,33483,101733,0,135216,0,
4266300,Johnny Matthew'S Hairdressing Training School,OR,135109,0,0,135109,0,
2265600,John Jay Beauty College,LA,135023,0,0,135023,0,
4243300,Garden State Science And Technology Institute,NJ,134873,0,0,134873,0,
4031300,Salon Professional Academy (The),ND,134350,0,0,134350,0,
172300,Meadville Theological School Of Lombard College,IL,26188,38060,70000,134248,0,
4206800,Advance Beauty Techs Academy,CA,134174,0,0,134174,0,
3094800,Industrial Management & Training Institute,CT,133714,0,0,133714,0,
163200,Aquinas Institute Of Theology,MO,19160,39833,74000,132993,0,
4222200,Fab School (The),CA,132973,0,0,132973,0,
3027400,Avalon School Of Cosmetology,CO,132880,0,0,132880,0,
2330600,Pennsylvania Gunsmith School,PA,132479,0,0,132479,0,
4158000,Metro Beauty Academy,PA,132460,0,0,132460,0,
2174800,Michael'S School Of Hair Design & Esthetics Paul Mitchell Partner Scho,NH,132378,0,0,132378,0,
4221700,Zms The Academy,CA,132113,0,0,132113,0,
761100,Eq School Of Hair Design,IA,132044,0,0,132044,0,
2125200,Margaret H. Rollins School Of Nursing At Beebe Medical Center,DE,49412,82625,0,132037,0,
4210200,Mid-South Christian College,TN,24705,38967,68000,131672,0,
2245300,Howell Cheney Technical High School,CT,31645,35706,64000,131351,0,
3617300,Healing Mountain Massage School,UT,131175,0,0,131175,0,
4220200,More Tech Institute,FL,130953,0,0,130953,0,
4158900,Flair Beauty College,CA,130763,0,0,130763,0,
3577300,Coba Academy,CA,130645,0,0,130645,0,
2202200,Stylemasters College Of Hair Design,WA,130349,0,0,130349,0,
4234200,Center For Ultrasound Research & Education,NY,129533,0,0,129533,0,
4243200,Central Yeshiva Beth Joseph,NY,32027,35423,62000,129450,0,
4184900,College Of International Esthetics,CO,129153,0,0,129153,0,
2320200,Houston Graduate School Of Theology,TX,21241,37777,70000,129018,0,
171200,Lutheran School Of Theology At Chicago,IL,22405,37553,69000,128958,0,
2559500,Salon Professional Academy (The),ID,128759,0,0,128759,0,
3469300,Ivaem College,PR,127721,0,0,127721,0,
865300,Jefferson County Dubois Area Vocational Techl School Practical Nursing,PA,49739,77543,0,127282,0,
3680300,Jay'S Technical Institute,TX,126939,0,0,126939,0,
2508900,Talmudic College Of Florida,FL,27499,36194,63000,126693,0,
2056500,Mitchell'S Academy,NC,125900,0,0,125900,0,
1300800,Summit Salon Academy - Portland,OR,125842,0,0,125842,0,
3646300,Design'S School Of Cosmetology,CA,125204,0,0,125204,0,
4275600,G.A. Beauty & Barber School,TX,124879,0,0,124879,0,
4174000,Skin Institute,MO,124835,0,0,124835,0,
4203200,Boise Barber College A D.Martin Academy,ID,124720,0,0,124720,0,
261900,New Brunswick Theological Seminary,NJ,24151,35388,65000,124539,0,
3776400,Orion Institute,OH,124387,0,0,124387,0,
4224500,Trenz Beauty Academy,IL,124177,0,0,124177,0,
4207400,Yeshiva Gedola Ohr Yisrael,NY,23803,36063,64000,123866,0,
794100,Salon Professional Academy (The),IA,123699,0,0,123699,0,
1062900,Pb Cosmetology Education Centre,NJ,122908,0,0,122908,0,
4255300,Hoss Lee Academy,CA,122657,0,0,122657,0,
4189800,Academy For Salon Professionals,CA,122587,0,0,122587,0,
3173300,Atlanta'S John Marshall Law School,GA,122500,0,0,122500,0,
4238200,Laredo Chi Academy Beauty School,TX,122419,0,0,122419,0,
2106100,College Of Cosmetology,OR,122071,0,0,122071,0,
4151500,American Academy Of Cosmetology,FL,122040,0,0,122040,0,
4186600,Summit Salon Academy Kokomo,IN,121654,0,0,121654,0,
510200,School Of Diagnostic Imaging-Cleveland Clinic Health System,OH,48618,72952,0,121570,0,
4204000,Aspen Beauty Academy - Laurel,MD,121302,0,0,121302,0,
4273900,Southeastern Esthetics Institute,SC,121278,0,0,121278,0,
4255600,International Diving Institute,SC,121044,0,0,121044,0,
4149400,Gary Manuel Aveda Institute,WA,121011,0,0,121011,0,
2560200,Phillips Theological Seminary,OK,14422,37560,69000,120982,0,
2099200,American Conservatory Theater Foundation,CA,25315,33386,62000,120701,0,
765900,La' James College Of Hairstyling,IA,120456,0,0,120456,0,
2235900,Academy Of Hair Design #4,MS,120390,0,0,120390,0,
3131300,Five Branches University,CA,120172,0,0,120172,0,
2328500,Moler - Pickens Beauty College,OH,119658,0,0,119658,0,
4230300,Paul Mitchell The School Merrillville,IN,119533,0,0,119533,0,
178300,Worsham College Of Mortuary Science,IL,119293,0,0,119293,0,
3668300,Birthingway College Of Midwifery,OR,18505,36531,64000,119036,0,
953100,Spa School (The),OH,118984,0,0,118984,0,
3759300,Stellar Career College,CA,118426,0,0,118426,0,
3103300,Jna Institute Of Culinary Arts,PA,118411,0,0,118411,0,
3324300,Central Career School,NJ,118376,0,0,118376,0,
4202800,Panache Academy Of Beauty,WI,118221,0,0,118221,0,
4184500,Christine Valmy International School Of Esthetics & Cosmetology,NJ,118012,0,0,118012,0,
826900,Hillyard Technical Center,MO,117910,0,0,117910,0,
2616600,Shear Ego International School Of Hair Design,NY,117714,0,0,117714,0,
2519300,Ohio State School Of Cosmetology,OH,117582,0,0,117582,0,
4133500,Academy For Five Element Acupuncture,FL,21823,33364,62000,117187,0,
4265400,Ann Webb Skin Institute,TX,117072,0,0,117072,0,
4226000,Bos-Man'S Barber College,LA,117057,0,0,117057,0,
4224700,Jb'S Hair Design And Barber College,OK,116861,0,0,116861,0,
4240800,Summit Christian College,NE,19025,35739,62000,116764,0,
4229900,Debutantes School Of Cosmetology And Nail Technology,IL,116746,0,0,116746,0,
408000,Starr King School For The Ministry,CA,23860,32584,60000,116444,0,
2544300,Butler Beauty Academy,PA,116401,0,0,116401,0,
4206700,Elite Welding Academy,OH,115917,0,0,115917,0,
3536300,Institute For Therapeutic Massage,NJ,115588,0,0,115588,0,
2192400,"Mr. John'S School Of Cosmetology, Esthetics & Nails",IL,115442,0,0,115442,0,
895500,Salon Professional Academy (The),PA,114999,0,0,114999,0,
4148200,Beyond 21St Century Beauty Academy,CA,114734,0,0,114734,0,
4213800,Salon Professional Academy (The),TN,114277,0,0,114277,0,
3306300,Rocky Mountain Montessori Teacher Training Program,CO,20588,33682,60000,114270,0,
4204800,American College Of Barbering,KY,114269,0,0,114269,0,
4269500,Goshen School Of Cosmetology,MS,114257,0,0,114257,0,
2536700,Bell Mar Beauty College,IL,113974,0,0,113974,0,
3027200,Blades School Of Hair Design,MD,113715,0,0,113715,0,
283300,Saint Vladimirs Orthodox Theological Seminary,NY,24442,31141,58000,113583,0,
626700,Unitypoint Health-Des Moines,IA,21716,28762,63000,113478,0,
3773300,Center For Natural Wellness School Of Massage Therapy,NY,113394,0,0,113394,0,
4229000,Barber Institute Of Texas,TX,113248,0,0,113248,0,
2285500,Creative Circus (The),GA,113193,0,0,113193,0,
2337900,College Of Hair Design Careers,OR,112927,0,0,112927,0,
4161700,Shasta School Of Cosmetology,CA,112740,0,0,112740,0,
3002000,Hairmasters Institute Of Cosmetology,IL,112704,0,0,112704,0,
166100,Chicago Theological Seminary,IL,17058,33605,62000,112663,0,
1192100,Westchester School Of Beauty Culture,NY,112451,0,0,112451,0,
3070200,Central College Of Cosmetology,MO,112354,0,0,112354,0,
3088800,"Watkins College Of Art, Design & Film",TN,112124,0,0,112124,0,
4116900,Digrigoli School Of Cosmetology,MA,111760,0,0,111760,0,
3005700,Detroit Business Institute - Downriver,MI,111552,0,0,111552,0,
3078400,Cameo Beauty Academy,IL,111227,0,0,111227,0,
3949300,Won Institute Of Graduate Studies,PA,18913,32274,60000,111187,0,
2118000,Levittown Beauty Academy,PA,111172,0,0,111172,0,
2263400,Lake Career & Technical Center,MO,18569,29492,63000,111061,0,
4189700,California Miramar University,CA,110771,0,0,110771,0,
125600,Pacific School Of Religion,CA,24442,30153,56000,110595,0,
2183600,Capri Institute Of Hair Design,NJ,110520,0,0,110520,0,
2494800,Cr'U Institute Of Cosmetology And Barbering,CA,110487,0,0,110487,0,
4127500,Cde Career Institute,PA,110238,0,0,110238,0,
4135000,Cozmo Beauty School,FL,110109,0,0,110109,0,
3095600,Ohio Technical Center At Vantage Career Center,OH,20672,89410,0,110082,0,
3100100,Paramount Beauty Academy,OH,109818,0,0,109818,0,
138700,Hartford Seminary,CT,17007,32702,60000,109709,47901000,
1293000,Charles & Sue'S School Of Hair Design,TX,109527,0,0,109527,0,
4223200,Grace International Beauty School,NY,109223,0,0,109223,0,
1063000,Northern Institute Of Cosmetology,OH,108952,0,0,108952,0,
2338600,Charzanne Beauty College,SC,108888,0,0,108888,0,
744700,Del-Mar-Va Beauty Academy,MD,108845,0,0,108845,0,
983100,Model College Of Hair Design,MN,108435,0,0,108435,0,
4236400,Sandra Academy Of Salon Services,TN,108427,0,0,108427,0,
4231000,Studio Beauty School,WA,108031,0,0,108031,0,
886400,Arizona Academy Of Beauty,AZ,107836,0,0,107836,0,
2551100,Pj'S College Of Cosmetology,KY,107097,0,0,107097,0,
3441300,Iowa School Of Beauty,IA,106994,0,0,106994,0,
4180200,Long Island Nail Skin & Hair Institute,NY,106834,0,0,106834,0,
2326000,Ucas University Of Cosmetology Arts & Sciences,TX,106620,0,0,106620,0,
3937300,Yeshiva College Of The Nation'S Capital,MD,19734,31640,55000,106374,0,
1174400,National Beauty College,OH,106210,0,0,106210,0,
865800,O'Briens Aveda Institute,VT,106040,0,0,106040,0,
4226100,Lawrence & Company College Of Cosmetology,CA,106027,0,0,106027,0,
4163400,Cosmo Beauty Academy,CA,105841,0,0,105841,0,
4246000,Michael K. Galvin Beauty & Business Academy,RI,105677,0,0,105677,0,
4073300,Jung Tao School Of Classical Chinese Medicine,NC,23569,28834,53000,105403,0,
1234700,Phagans' Central Oregon Beauty College,OR,105390,0,0,105390,0,
2146800,Joe Kubert School Of Cartoon & Graphic Art (The),NJ,105343,0,0,105343,0,
3783300,Blue Cliff Career College,AL,105082,0,0,105082,0,
953000,Gerber Akron Beauty School,OH,104975,0,0,104975,0,
4185900,Elite School Of Cosmetology,OH,104805,0,0,104805,0,
951500,J. Michael Harrold Beauty Academy,IN,104382,0,0,104382,0,
3491400,American Advanced Technicians Institute,FL,104373,0,0,104373,0,
1109800,Flint Institute Of Barbering,MI,104198,0,0,104198,0,
3009400,Nuvani Institute,TX,104127,0,0,104127,0,
4272800,Independent Training & Apprenticeship Program,CA,104035,0,0,104035,0,
4272100,Princess Institute Of Beauty,CA,103999,0,0,103999,0,
2560600,Pinnacle Institute Of Cosmetology,NC,103889,0,0,103889,0,
4112300,Louisiana Culinary Institute,LA,103694,0,0,103694,0,
3032400,Kc'S School Of Hair Design,MS,103552,0,0,103552,0,
1249600,Evergreen Beauty And Barber College,WA,103456,0,0,103456,0,
4209800,Hinton Barber And Beauty College,CA,103446,0,0,103446,0,
4156000,Academy Of Cosmetology & Esthetics Nyc (The),NY,102983,0,0,102983,0,
4191300,Annenberg School Of Nursing,CA,37770,65199,0,102969,0,
4237600,California Jazz Conservatory,CA,38567,64325,0,102892,0,
1161400,Champlain Valley Physicians Hospital Medical Center,NY,20970,29862,52000,102832,0,
2324400,Allstate Hairstyling & Barber College,OH,102790,0,0,102790,0,
3519300,Missouri College Of Cosmetology North,MO,102704,0,0,102704,0,
2251600,Academy Of Hair Design #6,MS,102117,0,0,102117,0,
4245800,Natural Images Beauty College,TX,102034,0,0,102034,0,
4258000,Seattle Film Institute,WA,101834,0,0,101834,0,
2352500,Cloyd'S Beauty School #3,LA,101047,0,0,101047,0,
2188300,Pentecostal Theological Seminary,TN,14436,30528,56000,100964,0,
4245400,Infinity College,LA,100915,0,0,100915,0,
4264800,J'S Barber College,LA,100902,0,0,100902,0,
4166800,Summit Salon Academy,OH,100760,0,0,100760,0,
2520300,Interior Designers Institute,CA,100622,0,0,100622,0,
3216300,Unification Theological Seminary,NY,20435,28113,52000,100548,0,
4014400,Palladium Technical Academy,CA,100425,0,0,100425,0,
3116200,Dayton Barber College,OH,100249,0,0,100249,0,
3419400,Northeastern Seminary,NY,15122,29988,55000,100110,0,
2167800,Estes Institute Of Cosmetology Arts & Sciences,CA,99744,0,0,99744,0,
895900,Clarksburg Beauty Academy & School Of Massage Therapy,WV,99727,0,0,99727,0,
2284200,New Tyler Barber College,AR,99723,0,0,99723,0,
4179700,United Beauty College,CO,99695,0,0,99695,0,
4224600,Barber School Of Pittsburgh,PA,99473,0,0,99473,0,
238600,United Theological Seminary Of The Twin Cities,MN,17458,28920,53000,99378,0,
3453400,Shawnee Beauty College,OK,99268,0,0,99268,0,
4249300,Salon Boutique Academy,TX,98873,0,0,98873,0,
4176700,Aveda Institute Boise,ID,98861,0,0,98861,0,
3986300,Aviator College Of Aeronautical Science & Technology,FL,98828,0,0,98828,0,
4277700,California College Of Barbering And Cosmetology,CA,98672,0,0,98672,0,
4246100,Nashville Film Institute,TN,98653,0,0,98653,0,
4262100,My Beauty & Barber College,CA,98476,0,0,98476,0,
4193100,Alexander Academy,MA,98351,0,0,98351,0,
2269300,Stevenson Academy Of Hair Design,LA,98324,0,0,98324,0,
2154400,Beau Monde Academy Of Cosmetology,OR,98322,0,0,98322,0,
2254000,New England Culinary Institute,VT,98063,0,0,98063,0,
3832400,Cosmetology School Of Arts And Sciences,ID,97960,0,0,97960,0,
2154000,Divers Academy Of The Eastern Seaboard,NJ,97783,0,0,97783,0,
1257300,West Virginia University Hospitals,WV,20244,27492,50000,97736,0,
250900,Saint Paul School Of Theology,KS,20672,27032,50000,97704,0,
4195300,Elevate Salon Institute,CO,97669,0,0,97669,0,
1288000,Celebrity Stylist Beauty School,LA,97628,0,0,97628,0,
4125500,Manuel & Theresa'S School Of Hair Design,TX,97462,0,0,97462,0,
2517100,Sarasota School Of Massage Therapy,FL,97165,0,0,97165,0,
2619200,Denham Springs Beauty College,LA,97153,0,0,97153,0,
959000,Summit Salon Academy Kansas City,MO,97014,0,0,97014,0,
2236400,"Thanh Le College, School Of Cosmetology",CA,96857,0,0,96857,0,
2302800,Mississippi College Of Beauty Culture,MS,96624,0,0,96624,0,
3374300,Florida Coastal School Of Law,FL,96603,0,0,96603,0,
1163100,D'Jay'S Institute Of Cosmetology And Esthiology,LA,96315,0,0,96315,0,
4205300,Mitsu Sato Hair Academy,KS,96274,0,0,96274,0,
4256400,San Bernardino Beauty College,CA,96223,0,0,96223,0,
4124100,Elite College Of Cosmetology,TN,96164,0,0,96164,0,
2103700,Capri Institute Of Hair Design,NJ,96142,0,0,96142,0,
4140200,"Mississippi Institute Of Aesthetics, Nails, & Cosmetology",MS,96122,0,0,96122,0,
4129900,Florida School Of Massage,FL,96011,0,0,96011,0,
2573700,Institute For Clinical Social Work,IL,15713,28239,52000,95952,0,
2529500,Hamrick School,OH,95932,0,0,95932,0,
2078800,Collectiv Hair Dressing Academy,UT,95923,0,0,95923,0,
2511500,"Joffrey Ballet School, American Ballet Center",NY,95735,0,0,95735,0,
4140500,Horizon University,IN,7486,31710,56000,95196,0,
4029300,Trendsetters Of Fl. School Of Beauty & Barbering,FL,95086,0,0,95086,0,
4219000,Iglobal University,VA,95038,0,0,95038,0,
947500,Educators Of Beauty College Of Cosmetology,IL,94989,0,0,94989,0,
2265500,Capri Institute Of Hair Design,NJ,94976,0,0,94976,0,
166300,Spertus College Of Judaica,IL,11595,29093,54000,94688,0,
2587700,Hair Professionals Career College,IL,94467,0,0,94467,0,
4153200,Southern Worcester County Regional Voc School District,MA,43105,51330,0,94435,0,
2159100,Appalachian Beauty School,KY,94425,0,0,94425,0,
4234600,Park Place Premier Barber School,LA,94356,0,0,94356,0,
3995300,University Of East-West Medicine,CA,94275,0,0,94275,0,
3814300,Turning Point Beauty College,AZ,94238,0,0,94238,0,
3822300,Paul Mitchell The School - Madison,WI,94232,0,0,94232,0,
3082100,Myotherapy College Of Utah,UT,94214,0,0,94214,0,
2349500,Cannella School Of Hair Design,IL,93948,0,0,93948,0,
3052000,Meredith Manor International Equestrian Centre,WV,93719,0,0,93719,0,
4246900,Piberry Institute,FL,93447,0,0,93447,0,
3203300,New York Institute Of Massage,NY,93376,0,0,93376,0,
2168100,Tri County Career Center/Adult Career Center,OH,22236,71019,0,93255,0,
4254900,Cincinnati School Of Barbering & Hair Design,OH,93183,0,0,93183,0,
4232000,Studio Incamminati,PA,14667,28403,50000,93070,0,
4165500,Acaydia Spa And School Of Aesthetics,UT,92748,0,0,92748,0,
4263000,Harmony Health Care Institute,NH,91855,0,0,91855,0,
4132600,Paul Mitchell The School - Lincoln,NE,91829,0,0,91829,0,
639200,Research Medical Center,MO,91737,0,0,91737,0,
4267500,International Barber College,AZ,91467,0,0,91467,0,
387400,Nashotah House,WI,16876,26136,48000,91012,0,
4232300,Hvac Technical Institute,IL,90904,0,0,90904,0,
849200,Chi Health School Of Radiologic Technology,NE,20297,23431,47000,90728,0,
2550600,Talmudical Institute Of Upstate New York,NY,17933,26497,46000,90430,0,
4144400,Academy Of Hair Design (The),OK,90375,0,0,90375,0,
2520800,Merrell University Of Beauty Arts & Science,MO,90177,0,0,90177,0,
4211000,Salon Professional Academy (The),AL,90139,0,0,90139,0,
4173000,Shepherds Theological Seminary,NC,16125,25893,48000,90018,0,
2061000,Venus Beauty Academy,PA,89682,0,0,89682,0,
4134000,"John Paolo'S Xtreme Beauty Institute, Goldwell Products Artistry",NY,89593,0,0,89593,0,
3962300,American Institute Of Massage Therapy,CA,89422,0,0,89422,0,
4217500,J D Academy Of Salon And Spa,CA,89296,0,0,89296,0,
928300,Midway Paris Beauty School,NY,89208,0,0,89208,0,
2275800,Mr. Leon'S School Of Hair Design,ID,89201,0,0,89201,0,
2327800,Pineville Beauty School,LA,89065,0,0,89065,0,
738800,Long Island Beauty School,NY,88800,0,0,88800,0,
4181600,Integrity College Of Health,CA,88763,0,0,88763,0,
2314000,Elevate Salon Institute,ID,88720,0,0,88720,0,
4264600,Hogan Institute Of Cosmetology And Esthetics,GA,88626,0,0,88626,0,
4251700,Hope College Of Arts And Sciences,FL,88555,0,0,88555,0,
4066300,Cardiac And Vascular Institute Of Ultrasound,AL,88302,0,0,88302,0,
4270100,Delta Designs Cosmetology School,AR,88170,0,0,88170,0,
116500,Church Divinity School Of The Pacific,CA,18783,24290,45000,88073,16243000,
3293300,Strand College Of Hair Design,SC,87957,0,0,87957,0,
3922300,South Texas Barber College,TX,87713,0,0,87713,0,
1292900,South Hills Beauty Academy,PA,87671,0,0,87671,0,
4148800,Centerpoint Massage & Shiatsu Therapy School & Clinic,MN,87374,0,0,87374,0,
4223400,Interamerican Technical Institute,FL,87212,0,0,87212,0,
2545800,Inner State Beauty School,OH,87203,0,0,87203,0,
4255400,Regan Career Institute,CA,87162,0,0,87162,0,
3916300,Eclips School Of Cosmetology And Barbering,MO,87102,0,0,87102,0,
4219100,Alexander Paul Institute Of Hair Design,NC,86901,0,0,86901,0,
3185300,Phagans' Grants Pass College Of Beauty,OR,86854,0,0,86854,0,
220200,Pope St. John Xxiii National Seminary,MA,21532,22984,42000,86516,0,
959500,Cannella School Of Hair Design,IL,86227,0,0,86227,0,
500800,Mountain State College,WV,86177,0,0,86177,0,
4260400,Cutting Edge Academy,NJ,85930,0,0,85930,0,
4167300,Salon Professional Academy (The),FL,85687,0,0,85687,0,
2158200,Washington Saratoga Warren Hamilton Essex Boces,NY,22752,20845,42000,85597,0,
2050300,Academy College,MN,85565,0,0,85565,0,
2552400,Academy Of Hair Technology,SC,85165,0,0,85165,0,
4240700,Image Maker Beauty Institute,TN,85137,0,0,85137,0,
2267100,Exposito School Of Hair Design,TX,84964,0,0,84964,0,
2214500,Salem College Of Hairstyling,MO,84962,0,0,84962,0,
3072600,Dci Career Institute,PA,84945,0,0,84945,0,
4212100,Academy Of Salon Professionals,MO,84787,0,0,84787,0,
3429300,Seacoast Career Schools,ME,84741,0,0,84741,0,
4249800,Dolce Llc The Academy,CT,84286,0,0,84286,0,
3367300,Professional Golfers Career College,CA,84229,0,0,84229,0,
4229700,First Coast Barber Academy,FL,83945,0,0,83945,0,
2362800,Austin Graduate School Of Theology,TX,10135,26735,47000,83870,0,
3082900,Rosel School Of Cosmetology,IL,83474,0,0,83474,0,
4188800,Institute For Doctoral Studies In The Visual Arts,ME,14258,24140,45000,83398,0,
1234800,Phagans' Beauty College,OR,83228,0,0,83228,0,
2536400,Louisiana Academy Of Beauty,LA,83167,0,0,83167,0,
2573100,Evans Hairstyling College Of Cedar City,UT,83133,0,0,83133,0,
4273500,Winonah'S International School Of Cosmetology,AL,82925,0,0,82925,0,
4243500,Barber Tech Academy,SC,82720,0,0,82720,0,
2230900,Fredrick And Charles Beauty College,CA,82451,0,0,82451,0,
2220000,Colleen O'Hara'S Beauty Academy,CA,82427,0,0,82427,0,
4242300,Dalton Institute Of Esthetics And Cosmetology,GA,82217,0,0,82217,0,
1191900,Beaver Falls Beauty Academy,PA,82135,0,0,82135,0,
4174200,All Beauty College,AZ,82062,0,0,82062,0,
2609000,Emperor'S College Of Traditional Oriental Medicine,CA,82054,0,0,82054,0,
3872400,Divine Mercy University,VA,12649,24391,45000,82040,0,
3042800,"School Board - City Of Va. Beach, Va. Beach School Of Prctl. Nrsg.",VA,28074,53783,0,81857,0,
1074100,Academy Of Salon And Spa,AR,81774,0,0,81774,0,
4204300,"Aesthetic Science Institute, Llc (The)",NY,81723,0,0,81723,0,
3007100,Hot Springs Beauty College,AR,81480,0,0,81480,0,
4152700,Astrodome Career Centers,TX,81224,0,0,81224,0,
3888300,Dragon Rises College Of Oriental Medicine,FL,18040,21995,41000,81035,0,
4233900,Atlantis University,FL,80885,0,0,80885,0,
3061200,Midwest College Of Oriental Medicine,WI,80513,0,0,80513,0,
129600,Dominican School Of Philosophy And Theology,CA,13676,23500,43000,80176,0,
1202000,Victoria Beauty College,TX,79984,0,0,79984,0,
4158800,Theatre Of Arts,CA,79898,0,0,79898,0,
2058600,Bk Cosmo College Of Cosmetology,TX,79091,0,0,79091,0,
1284800,Moler Hollywood Beauty Academy,OH,79077,0,0,79077,0,
4132400,Academy Of Esthetics And Cosmetology,CA,79073,0,0,79073,0,
745900,Paier College Of Art,CT,78906,0,0,78906,0,
2211600,Paul Mitchell The School Portsmouth,NH,78689,0,0,78689,0,
2601100,Opelousas School Of Cosmetology,LA,78578,0,0,78578,0,
4268300,Rexburg College Of Massage Therapy,ID,78561,0,0,78561,0,
3757300,Advance Science International College,FL,78324,0,0,78324,0,
3316400,Fine Mortuary College,MA,78045,0,0,78045,0,
4248800,Wongu University Of Oriental Medicine,NV,14840,21995,41000,77835,0,
4255500,Alabama School Of Nail Technology & Cosmetology,AL,77735,0,0,77735,0,
4267700,Esthetic Institute (The),VA,77722,0,0,77722,0,
4002400,Ecumenical Theological Seminary,MI,14258,22226,41000,77484,0,
4250200,Focus Personal Training Institute,NY,77434,0,0,77434,0,
2304800,Pj'S College Of Cosmetology,IN,77190,0,0,77190,0,
790000,Butte Academy Of Beauty Culture,MT,77189,0,0,77189,0,
182300,Anabaptist Mennonite Biblical Seminary,IN,12438,22444,42000,76882,0,
281500,Saint Bernard'S School Of Theology And Ministry,NY,13676,21958,41000,76634,0,
4256100,Indiana College Of Sports & Medical Massage,IN,76551,0,0,76551,0,
3054100,Royale College Of Beauty And Barbering,CA,76241,0,0,76241,0,
1244600,Universal College Of Beauty,CA,76226,0,0,76226,0,
2526100,Jenny Lea Academy Of Cosmetology,KY,76044,0,0,76044,0,
4179800,Sotheby'S Institute Of Art - Ny,NY,75653,0,0,75653,0,
4244100,Construction Training Center,SC,75525,0,0,75525,0,
2285700,Bayshire Beauty Academy,MI,75520,0,0,75520,0,
4168800,Abc Beauty Academy,TX,75257,0,0,75257,0,
4209500,Shear Finesse Beauty Academy,FL,75116,0,0,75116,0,
3829500,Skinworks School Of Advanced Skincare,UT,74698,0,0,74698,0,
3327400,"Acupuncture And Integrative Medicine College, Berkeley",CA,31425,42818,0,74243,0,
249400,Nazarene Theological Seminary,MO,13954,21141,39000,74095,0,
2521800,Seguin Beauty School,TX,74070,0,0,74070,0,
4178500,Vogue College Of Cosmetology,NM,74042,0,0,74042,0,
2271300,Wisconsin School Of Professional Psychology,WI,13967,21071,39000,74038,0,
2280500,Charles Of Italy Beauty College,AZ,74036,0,0,74036,0,
270000,Colgate Rochester Crozer Divinity School,NY,13094,21299,39000,73393,0,
2329900,Florida Institute Of Ultrasound,FL,73059,0,0,73059,0,
3608300,Caribbean Forensic & Technical College,PR,72934,0,0,72934,0,
3220300,"Professional Hair Design Academy, The",WI,72826,0,0,72826,0,
2491000,West Michigan College Of Barbering And Beauty,MI,72745,0,0,72745,0,
3584400,Colorado School Of Healing Arts,CO,72624,0,0,72624,0,
2061600,Wayne'S College Of Beauty,CA,72461,0,0,72461,0,
4231300,Yahweh Beauty Academy,TX,72253,0,0,72253,0,
4169400,Northern Virginia School Of Therapeutic Massage,VA,71989,0,0,71989,0,
4239000,B-Unique Beauty And Barber Academy,SC,71620,0,0,71620,0,
4134300,Evans Hairstyling College,ID,71597,0,0,71597,0,
4190500,New York School Of Esthetics & Day Spa,NY,71583,0,0,71583,0,
4044300,Hazelden Graduate School Of Addiction Studies,MN,16012,19558,36000,71570,0,
4055300,Creative Hair School Of Cosmetology,MI,71456,0,0,71456,0,
3786300,Advanced College,CA,71329,0,0,71329,0,
3881400,European Massage Therapy School (The),NV,71306,0,0,71306,0,
4161900,Mandalyn Academy,UT,71253,0,0,71253,0,
2518900,Barrett & Company School Of Hair Design,KY,70869,0,0,70869,0,
4145000,San Diego Culinary Institute,CA,70731,0,0,70731,0,
4197500,University Academy Of Hair Design,AL,70719,0,0,70719,0,
4132800,Inland Massage Institute,WA,70663,0,0,70663,0,
2182200,New School Center For Media,NY,70490,0,0,70490,0,
4128800,Branford Academy Of Hair & Cosmetology,CT,70305,0,0,70305,0,
2126500,Enid Beauty College,OK,70272,0,0,70272,0,
4188700,Asi Career Institute,NJ,70108,0,0,70108,0,
4267900,Brown Beauty Barber School,AL,70098,0,0,70098,0,
2588500,Ohio State School Of Cosmetology,OH,70032,0,0,70032,0,
4177600,Lindsey Institute Of Cosmetology,KY,69690,0,0,69690,0,
4101300,Carolina School Of Broadcasting,NC,69411,0,0,69411,0,
197100,Lexington Theological Seminary,KY,7748,21480,40000,69228,0,
2315500,Toledo Academy Of Beauty Culture - East,OH,69228,0,0,69228,0,
2595700,Hillsdale Beauty College,MI,69128,0,0,69128,0,
4155500,Academy For Jewish Religion California,CA,12221,19897,37000,69118,0,
657800,Sharon Regional School Of Nursing,PA,68940,0,0,68940,0,
4139400,Hair Academy (The),ND,68765,0,0,68765,0,
4118600,Tricoci University Of Beauty Culture,WI,68585,0,0,68585,0,
356600,Episcopal Theological Seminary Of The Southwest (The),TX,29097,39401,0,68498,0,
4141100,French Academy Of Cosmetology,MI,68450,0,0,68450,0,
4238700,Dermal Science International Aesthetics & Nail Academy,VA,68341,0,0,68341,0,
2257400,Arnold'S Beauty School,TN,68240,0,0,68240,0,
3702300,Delaware Learning Institute Of Cosmetology,DE,68172,0,0,68172,0,
3801400,Beauty Institute (The),FL,67958,0,0,67958,0,
4244700,Med Academy,FL,67956,0,0,67956,0,
2060900,Brown College Of Court Reporting,GA,67945,0,0,67945,0,
4225900,Setting The Standard Barbering And Natural Hair Academy,LA,67932,0,0,67932,0,
4241800,Academy Of Professional Cosmetology,AR,67844,0,0,67844,0,
4157200,Love Beauty School,TN,67806,0,0,67806,0,
2356600,Charleston Cosmetology Institute,SC,67783,0,0,67783,0,
4269600,Ibs School Of Cosmetology And Massage,HI,67672,0,0,67672,0,
2531200,Formations Institute Of Cosmetology & Barbering Llc,OK,67651,0,0,67651,0,
3747300,Bexley Seabury Seminary Federation,IL,6110,21505,40000,67615,0,
960000,"Cosmetology Careers Unlimited College Of Hair, Skin, And Nails",MN,67512,0,0,67512,0,
2065700,California Beauty College,CA,67420,0,0,67420,0,
4146100,Urshan Graduate School Of Theology,MO,10234,20077,37000,67311,0,
4274700,Centralia Beauty College,WA,66750,0,0,66750,0,
3822400,Maple Springs Baptist Bible College & Seminary,MD,5620,21677,39000,66297,0,
4189000,Barber & Beauty Institute Of New York,NY,66110,0,0,66110,0,
4250600,California Institute Of Advanced Management,CA,15039,50997,0,66036,0,
4239700,Vocational Nursing Institute (The),TX,17734,48103,0,65837,0,
4138200,Salon Professional Academy (The),WI,65719,0,0,65719,0,
4146500,Portland Actors Conservatory,OR,15222,17450,33000,65672,0,
2604700,Center For Advanced Legal Studies,TX,65587,0,0,65587,0,
492400,Forrest College,SC,65558,0,0,65558,0,
4257700,Totally Cosmo School Of Modern Cosmetology,OK,65291,0,0,65291,0,
2510300,Beauty Technical College,OK,65203,0,0,65203,0,
2587600,Orlo School Of Hair Design & Cosmetology (The),NY,65152,0,0,65152,0,
4243100,Alhambra Medical University,CA,65078,0,0,65078,0,
4228400,Beyond Measure Barbering Institute,NC,65065,0,0,65065,0,
2262500,Faust Institute Of Cosmetology,IA,65010,0,0,65010,0,
4257900,American Barber And Beauty Academy,PA,64928,0,0,64928,0,
3109800,Ponca City Beauty College,OK,64850,0,0,64850,0,
2495000,Robert Paul Academy Of Cosmetology Arts & Sciences,MD,64827,0,0,64827,0,
1229100,Wright Beauty Academy,MI,64647,0,0,64647,0,
3934300,Yeshiva Zichron Aryeh,NY,14059,18253,32000,64312,0,
3840300,Omega Graduate School,TN,10184,19096,35000,64280,0,
4155800,Advanced Beauty College,TX,64217,0,0,64217,0,
1248800,International Beauty College #3,TX,64097,0,0,64097,0,
4172500,Rolf Institute Of Structural Integration (The),CO,23419,40573,0,63992,0,
4247600,New Beginnings Beauty Academy,AR,63880,0,0,63880,0,
3429700,East West College Of Natural Medicine,FL,63723,0,0,63723,0,
1321800,M.J. Murphy Beauty College,MI,63536,0,0,63536,0,
3277300,Pathway Vocational Academy,TX,63239,0,0,63239,0,
4276700,Salon Professional Academy (The),TX,63166,0,0,63166,0,
2163500,New England School Of Photography,MA,62906,0,0,62906,0,
4189400,Shear Learning Academy Of Cosmetology,IL,62701,0,0,62701,0,
3068400,Quality Technical & Beauty College,PR,62586,0,0,62586,0,
3019900,Capstone College,CA,62462,0,0,62462,0,
960700,House Of Heavilin Beauty College,MO,62404,0,0,62404,0,
4179200,Advanced College Of Cosmetology,WI,62265,0,0,62265,0,
4184300,Paul Mitchell The School Ardmore,OK,61953,0,0,61953,0,
2197500,Baton Rouge School Of Computers,LA,61790,0,0,61790,0,
282200,Christ The King Seminary,NY,11057,17714,33000,61771,0,
4214500,Prestige Health & Beauty Sciences Academy,FL,61112,0,0,61112,0,
2349200,Headmasters School Of Hair Design,ID,61086,0,0,61086,0,
3164300,Creative Center (The),NE,61073,0,0,61073,0,
4250800,Mission Beauty Institute,TX,61068,0,0,61068,0,
4119200,Eagle Rock College,CA,60954,0,0,60954,0,
2595000,Hair Academy The,TN,60842,0,0,60842,0,
2164300,Don Roberts School Of Hair Design,IN,60627,0,0,60627,0,
4163700,Bitterroot School Of Cosmetology,MT,60612,0,0,60612,0,
2278700,Mister Wayne'S School Of Unisex Hair Design,TN,60570,0,0,60570,0,
4233400,Lee Professional Institute,FL,60437,0,0,60437,0,
1012200,Phagans' Medford Beauty School,OR,60405,0,0,60405,0,
1294800,Rob Roy Academy,MA,60343,0,0,60343,0,
4213400,Access Careers,NY,60255,0,0,60255,0,
406000,Winebrenner Theological Seminary,OH,12366,16856,31000,60222,0,
4272400,Northern Technical College,AR,59671,0,0,59671,0,
4176300,Bergin College Of Canine Studies,CA,25825,33669,0,59494,0,
3179500,Texas Health And Science University,TX,59416,0,0,59416,0,
720900,Redondo Beach Beauty College,CA,58790,0,0,58790,0,
2309100,American College Of Hair Design,MO,58724,0,0,58724,0,
4006300,Nuvo College Of Cosmetology,MI,58614,0,0,58614,0,
4123900,Lexington Healing Arts Academy,KY,58500,0,0,58500,0,
3238300,Florida College Of Integrative Medicine,FL,58486,0,0,58486,0,
1109700,Cloyd'S Beauty School #1,LA,58274,0,0,58274,0,
4192600,Palmetto Beauty School,SC,58220,0,0,58220,0,
4271000,Stacey James Institute,CO,58169,0,0,58169,0,
3025600,Dell'Arte International School Of Physical Theatre,CA,14549,15343,28000,57892,0,
2289000,American Hair Academy,IA,57867,0,0,57867,0,
3218300,University Of The Potomac,DC,57862,0,0,57862,0,
3110900,House Of Heavilin Of Blue Springs,MO,57775,0,0,57775,0,
2556600,Niles School Of Cosmetology,IL,57709,0,0,57709,0,
2249900,Delta Beauty College,MS,57587,0,0,57587,0,
4130700,Academy Of Massage And Bodywork,DE,57444,0,0,57444,0,
2251700,Foster'S Cosmetology College,MS,57219,0,0,57219,0,
3103800,Southern School Of Beauty,OK,57017,0,0,57017,0,
4158100,Aiken School Of Cosmetology And Barbering,SC,56697,0,0,56697,0,
3498400,Omega Institute Of Cosmetology,LA,56616,0,0,56616,0,
4119600,Yeshiva Of Far Rockaway Derech Ayson Rabbinical Seminary,NY,23752,32799,0,56551,0,
2306900,Iowa School Of Beauty,IA,56508,0,0,56508,0,
2270500,Bucks County School Of Beauty Culture,PA,55682,0,0,55682,0,
4269700,Ur Beauty & Barber Academy,FL,55477,0,0,55477,0,
3684300,Northshore University Healthsystem School Of Nurse Anesthesia,IL,23860,31511,0,55371,0,
3110400,Paul Mitchell The School St. George,UT,55312,0,0,55312,0,
4213200,Kaizen Beauty Academy,FL,55217,0,0,55217,0,
4117900,Champion Beauty College,TX,55136,0,0,55136,0,
4271600,"Avenue Academy, A Cosmetology Institute (The)",NM,54745,0,0,54745,0,
4250300,Hair Academy School Of Barbering & Beauty,DE,54631,0,0,54631,0,
4256600,Mak Beauty Institute,GA,54557,0,0,54557,0,
4252900,International Beauty Education Center,WA,54461,0,0,54461,0,
2092100,Massachusetts School Of Barbering,MA,54414,0,0,54414,0,
4222600,Healthcare Institute (The),TX,54372,0,0,54372,0,
2290400,Altoona Beauty School,PA,54362,0,0,54362,0,
3821400,Universal College Of Healing Arts,NE,54312,0,0,54312,0,
2358500,Bon Secours St Mary'S Hospital School Of Medical Imaging,VA,22589,31687,0,54276,0,
720400,Modern Beauty Academy - Oxnard,CA,54154,0,0,54154,0,
2297500,Oehrlein School Of Cosmetology,IL,54088,0,0,54088,0,
3746300,Legrand Institute Of Cosmetology,SC,54018,0,0,54018,0,
2202400,Professional Cosmetology Education Center,AR,53985,0,0,53985,0,
2145100,Scott College Of Cosmetology,WV,53972,0,0,53972,0,
2097300,Hastings Beauty School,MN,53763,0,0,53763,0,
4141600,Omega Studios' School Of Applied Recording Arts & Sciences,MD,53482,0,0,53482,0,
2314200,Empire Beauty School,NY,53477,0,0,53477,0,
4178100,Carolina College Of Hair Design,NC,53472,0,0,53472,0,
328600,Lancaster Theological Seminary Of The United Church Of Christ,PA,19204,34212,0,53416,0,
4038400,Avi Career Training,VA,53197,0,0,53197,0,
3667300,Faith Theological Seminary,MD,53194,0,0,53194,0,
3163300,Pacific States University,CA,13385,13801,26000,53186,0,
3976300,Massage Therapy Institute Of Colorado,CO,53176,0,0,53176,0,
4137200,Borner'S Barber College,CA,53064,0,0,53064,0,
3968300,Lakewood School Of Therapeutic Massage,MI,52948,0,0,52948,0,
1235100,Phagans' School Of Beauty,OR,52869,0,0,52869,0,
4173400,Santa Ana Beauty Academy,CA,52745,0,0,52745,0,
3643300,Mr. John'S School Of Cosmetology & Nails,IL,52727,0,0,52727,0,
4160500,Avalon School Of Cosmetology,MN,52436,0,0,52436,0,
4269800,L Makeup Institute,NV,52324,0,0,52324,0,
1147700,Sanford Medical Center,SD,13385,13736,25000,52121,0,
2572700,Evans Hairstyling College,UT,52053,0,0,52053,0,
4021300,Augusta School Of Massage,GA,52041,0,0,52041,0,
3676300,Family Of Faith Christian University,OK,6040,16531,29000,51571,0,
4277400,Elite Academy Of Hair Design,OH,51496,0,0,51496,0,
4274100,Arkansas Welding Academy,AR,51346,0,0,51346,0,
3612300,Birthwise Midwifery School,ME,51189,0,0,51189,0,
4231800,Princess Beauty School,MI,51144,0,0,51144,0,
3090000,Sharp'S Academy Of Hairstyling,MI,50808,0,0,50808,0,
941900,State College Of Beauty Culture,WI,50340,0,0,50340,0,
4038700,Ideal Beauty Academy,KY,50189,0,0,50189,0,
1179200,Franciscan School Of Theology,CA,7856,14789,27000,49645,0,
4215000,Total Transformation Institute Of Cosmetology,TX,49523,0,0,49523,0,
3027300,Blalock'S Professional Beauty College,LA,48933,0,0,48933,0,
4276500,Global Medical & Technical Training Institute,FL,48533,0,0,48533,0,
3538300,Alexandria School Of Scientific Therapeutics,IN,48376,0,0,48376,0,
4248900,Vh Barber & Styling Academy,LA,48247,0,0,48247,0,
4202600,New Dimensions Beauty Academy,CO,48218,0,0,48218,0,
3111000,Mid Cities Barber College,TX,48082,0,0,48082,0,
4121200,Institute Of Taoist Education And Acupuncture,CO,11057,12975,24000,48032,0,
4028300,Mountain State School Of Massage,WV,47967,0,0,47967,0,
2202600,Cannella School Of Hair Design,IL,47966,0,0,47966,0,
4148400,Tigi Hairdressing Academy Guilford,CT,47853,0,0,47853,0,
3279300,Myotherapy Institute,NE,47524,0,0,47524,0,
2245400,Keene Beauty Academy,NH,47439,0,0,47439,0,
4228600,Top Of The Line Barber College,SC,47386,0,0,47386,0,
4148700,American Institute Of Interior Design,AZ,47278,0,0,47278,0,
4215500,Champ'S Barber School,PA,47263,0,0,47263,0,
4276400,Culinary School Of Fort Worth (The),TX,47260,0,0,47260,0,
3841300,Career Beauty College,TN,47255,0,0,47255,0,
4242600,Abco Technology,CA,46979,0,0,46979,0,
4225300,Creative Touch Cosmetology School,IL,46816,0,0,46816,0,
4146900,Advanced Welding Institute,VT,46587,0,0,46587,0,
966000,Tiffin Academy Of Hair Design,OH,46336,0,0,46336,0,
2323300,Professionals Choice Hair Design Academy,IL,46213,0,0,46213,0,
4192000,Curve Metric School Of Hair Design,IL,46054,0,0,46054,0,
3153300,American College Of Acupuncture & Oriental Medicine,TX,45939,0,0,45939,0,
4214700,Luckes Beauty Academy,VA,45259,0,0,45259,0,
2338000,Cloyd'S Barber School #2,LA,44745,0,0,44745,0,
893900,Cannella School Of Hair Design,IL,44650,0,0,44650,0,
3101000,New Dimension School Of Hair Design,MO,44577,0,0,44577,0,
4129400,Center For Massage & Natural Health,NC,44551,0,0,44551,0,
4213600,River Valley Cosmetology Institute,OK,44407,0,0,44407,0,
4182500,Millennia Atlantic University,FL,44229,0,0,44229,0,
3156400,Aoma Graduate School Of Integrative Medicine,TX,44228,0,0,44228,0,
4229200,Jupiter Beauty Academy,MA,44219,0,0,44219,0,
4247700,Regina Webb Academy,KY,44105,0,0,44105,0,
849800,William Edge Institute,TX,44088,0,0,44088,0,
4226300,Divine Crown Barber & Beauty Academy,PA,44060,0,0,44060,0,
4260000,Institute Of Medical Ultrasound,GA,43581,0,0,43581,0,
2621300,Academy Of Cosmetology,MT,43527,0,0,43527,0,
4266100,Apex Academy Hair Skin Nails School Of Cosmetology,OH,43429,0,0,43429,0,
4136900,University Of Aesthetics & Cosmetology,IL,43036,0,0,43036,0,
4248200,Dehart Technical School,CA,42994,0,0,42994,0,
4246600,Textures Institute Of Cosmetology,IN,42921,0,0,42921,0,
3997300,Arkansas Beauty College,AR,42819,0,0,42819,0,
4238900,"Beauty School, (The)",AR,42726,0,0,42726,0,
3800300,Colegio Técnico De Electricidad Galloza,PR,42670,0,0,42670,0,
3437300,Upper Valley Educators Institute,NH,8729,16699,17000,42428,0,
4267300,Lehigh Valley Barber School,PA,42426,0,0,42426,0,
884400,California Christian College,CA,12359,30024,0,42383,0,
1318900,Continental Academie Of Hair Design,NH,42043,0,0,42043,0,
4229100,Advantage Career Institute,NJ,41609,0,0,41609,0,
456000,Gem City College,IL,41594,0,0,41594,0,
4239600,Kentucky Horseshoeing School,KY,41510,0,0,41510,0,
4236800,Fountain Of Youth Academy Of Cosmetology,PA,41507,0,0,41507,0,
2332200,Hair Professionals Career College,IL,41496,0,0,41496,0,
2292700,Lansdale School Of Cosmetology,PA,41255,0,0,41255,0,
4271700,Salon Professional Academy Of San Antonio (The),TX,41200,0,0,41200,0,
423300,Saint Luke'S Methodist Hospital School Of Radiologic Technology,IA,18551,22360,0,40911,0,
2273400,Reconstructionist Rabbinical College,PA,8438,11390,21000,40828,0,
1162200,Welder Training & Testing Institute,PA,40685,0,0,40685,0,
2228100,Steven Papageorge Hair Academy,IL,40486,0,0,40486,0,
3079100,North Central Institute,TN,40259,0,0,40259,0,
953700,Virginia School Of Hair Design,VA,40047,0,0,40047,0,
4223300,Alliance Computing Solutions,NY,40031,0,0,40031,0,
4253700,Sacramento Ultrasound Institute,CA,39829,0,0,39829,0,
1167700,Memorial Sloan Kettering Cancer Center,NY,7585,11233,21000,39818,0,
4167400,Sage School Of Massage & Esthetics,OR,39511,0,0,39511,0,
2608000,Neosho Beauty College,MO,39487,0,0,39487,0,
4236900,K&G 5 Star Barber College,TX,39446,0,0,39446,0,
894600,Port Huron Cosmetology College,MI,39026,0,0,39026,0,
4255100,U.S. Truck Driver Training School,MI,38918,0,0,38918,0,
4274500,Strand Institute Of Beauty & Esthetics (The),TX,38506,0,0,38506,0,
4275100,Anousheh School Of Hair,NY,38286,0,0,38286,0,
4263500,American Beauty Schools,FL,38193,0,0,38193,0,
4137000,University Of Aesthetics & Cosmetology (The),IL,37971,0,0,37971,0,
4275900,Another Level Barbering And Cosmetology School,VA,37931,0,0,37931,0,
4268000,Kor Beauty Academy,AZ,37326,0,0,37326,0,
3617500,Phoenix Institute Of Herbal Medicine & Acupuncture,AZ,37245,0,0,37245,0,
4177900,Buckner Barber School,TX,37184,0,0,37184,0,
4227500,Merryfield School Of Pet Grooming,FL,37149,0,0,37149,0,
2176100,Pipo Academy Of Hair Design,TX,37076,0,0,37076,0,
4268100,Ray J'S College Of Hair,LA,36978,0,0,36978,0,
4217400,High Tech High Graduate School Of Education,CA,6110,10792,20000,36902,0,
3214300,Velvatex College Of Beauty Culture,AR,36831,0,0,36831,0,
4168900,Holistic Massage Training Institute,MD,36599,0,0,36599,0,
4150600,Urban 113 School Of Cosmetology,ID,36448,0,0,36448,0,
4261300,European Medical School Of Massage,PA,36317,0,0,36317,0,
3109100,"Workforce Institute'S City College, The",PA,17617,18063,0,35680,0,
4246200,California Institute Of Medical Science,CA,35107,0,0,35107,0,
2113800,Roberto-Venn School Of Luthiery,AZ,35092,0,0,35092,0,
2516200,Wesley Biblical Seminary,MS,4013,11034,20000,35047,0,
4234000,San Francisco Film School,CA,34950,0,0,34950,0,
163700,Bethany Theological Seminary,IN,5547,10344,19000,34891,0,
4243900,University Of Texas Health Science Center At Tyler (The),TX,9311,25459,0,34770,0,
4253100,Allied Health Careers Institute,TN,34679,0,0,34679,0,
959300,La' James International College,IA,34528,0,0,34528,0,
4232800,John Patrick University Of Health And Applied Sciences,IN,34392,0,0,34392,0,
4159300,Marketti Academy Of Cosmetology,MI,34387,0,0,34387,0,
4162200,American Academy Of Health And Beauty,NH,34010,0,0,34010,0,
4093300,Academy Of Natural Therapy,CO,33501,0,0,33501,0,
4183000,Top Nails & Hair Beauty School,UT,33446,0,0,33446,0,
2274100,La' James International College - Des Moines,IA,33414,0,0,33414,0,
4240600,Tri-State Barber College,KY,33384,0,0,33384,0,
2351300,Knox Beauty College,IN,32917,0,0,32917,0,
4177500,Pure Aesthetics Natural Skincare School,AZ,32907,0,0,32907,0,
3686300,Colorado School Of Traditional Chinese Medicine,CO,32880,0,0,32880,0,
492900,Avera Mckennan Hospital,SD,6110,9372,17000,32482,0,
2137000,Rob Roy Academy,MA,32113,0,0,32113,0,
2556500,Yukon Beauty College,OK,31965,0,0,31965,0,
3051500,Us Grant Joint Vocational School,OH,6833,25117,0,31950,0,
4167800,Innovations Design Academy,IL,31827,0,0,31827,0,
4142700,Pontifical John Paul Ii Institute For Studies On Marriage And Family,DC,12221,19424,0,31645,0,
2533200,School Of Architecture At Taliesin (The),AZ,3492,9577,18000,31069,0,
3096200,Charles Stuart School,NY,30844,0,0,30844,0,
4156200,Institute Of Advanced Medical Esthetics,VA,30626,0,0,30626,0,
4247400,Ea La Mar'S Cosmetology & Barber College,MO,30499,0,0,30499,0,
3983300,"School Of Professional Horticulture, N. Y. Botanical Garden",NY,12767,17482,0,30249,0,
4249500,Lebanon College Of Cosmetology,MO,30034,0,0,30034,0,
4236700,Blush School Of Makeup,CA,29877,0,0,29877,0,
3109700,Cadillac Institute Of Cosmetology,MI,29719,0,0,29719,0,
3568300,Leon Studio One School Of Beauty Knowledge,NY,29227,0,0,29227,0,
4231400,Bella Academy Of Cosmetology,WI,29101,0,0,29101,0,
4267200,Allgood Beauty Institute,TX,29054,0,0,29054,0,
4211200,Brighton Institute Of Cosmetology,MI,29053,0,0,29053,0,
4080300,Aspen University,CO,28984,0,0,28984,0,
2339400,Rob Roy Academy,MA,28869,0,0,28869,0,
4223900,Mind Body Institute,TN,28782,0,0,28782,0,
2538800,Suffolk Beauty Academy,VA,28655,0,0,28655,0,
2134500,La' James International College,IA,28646,0,0,28646,0,
953500,Staunton School Of Cosmetology,VA,28378,0,0,28378,0,
4139300,National Beauty College,CO,28336,0,0,28336,0,
4203600,Franklin Hair Academy School Of Cosmetology,TN,28291,0,0,28291,0,
3032500,Alabama State College Of Barber Styling,AL,28259,0,0,28259,0,
4267100,Unlimited Cosmetology School,MS,28162,0,0,28162,0,
2247000,New England School Of Hair Design,NH,27906,0,0,27906,0,
4168600,College Of Massage Therapy,ID,27849,0,0,27849,0,
4258900,Master'S Barber & Styling College,TN,27762,0,0,27762,0,
4173900,Evolve Beauty Academy,MO,27103,0,0,27103,0,
4146400,Daoist Traditions College Of Chinese Medical Arts,NC,27061,0,0,27061,0,
272600,General Theological Seminary Of The Episcopal Church (The),NY,10475,16375,0,26850,0,
2622000,Southwest Acupuncture College,NM,26770,0,0,26770,0,
4246500,Massage Institute Of Memphis (The),TN,26324,0,0,26324,0,
2567600,Sumter Beauty College,SC,24772,0,0,24772,0,
4224200,Belle Academy Of Cosmetology,CT,24212,0,0,24212,0,
3280300,Seattle Institute Of East Asian Medicine,WA,24151,0,0,24151,0,
3859300,Eine Electrology/Esthetics Institute Of Ne,MA,23996,0,0,23996,0,
4252400,Worldclass Academy Of Beauty Careers,FL,23877,0,0,23877,0,
4223500,Lynnes Welding Training,ND,23803,0,0,23803,0,
3720300,Carlson College Of Massage Therapy,IA,23609,0,0,23609,0,
2520200,California Career School,CA,23569,0,0,23569,0,
2274300,Conway School Of Landscape Design,MA,6692,5869,11000,23561,0,
2111600,Sovah School Of Health Professions,VA,23286,0,0,23286,0,
112000,American Baptist Seminary Of The West,CA,9311,13958,0,23269,0,
4216500,Rizzieri Institute,NJ,23111,0,0,23111,0,
4246700,Learning Bridge Career Institute,LA,22916,0,0,22916,0,
1300600,La'James International College,IA,22241,0,0,22241,0,
4249400,Center For Neurosomatic Studies,FL,21825,0,0,21825,0,
3833300,American Academy Of Traditional Chinese Medicine,MN,21532,0,0,21532,0,
3638300,Rosslyn Training Academy Of Cosmetology,PR,21345,0,0,21345,0,
337500,Theological Seminary Reformed Episcopal Church,PA,4074,6200,11000,21274,0,
4248000,"Recording Conservatory Of Austin, (The)",TX,20622,0,0,20622,0,
4185500,Beverly Hills Design Institute,CA,20598,0,0,20598,0,
335800,Reformed Presbyterian Theological Seminary,PA,20401,0,0,20401,0,
3811300,Eastern School Of Acupuncture And Traditional Medicine,NJ,19495,0,0,19495,0,
2337400,Bancroft School Of Massage Therapy,MA,19166,0,0,19166,0,
2120600,Saybrook University,CA,3469,5623,10000,19092,0,
1069500,Tri County Beauty Academy,IL,18823,0,0,18823,0,
3966300,Virginia Beach Theological Seminary,VA,3070,5421,10000,18491,0,
3110800,Bakke Graduate University,TX,2662,5600,10000,18262,0,
1015100,Vincennes Beauty College,IN,18044,0,0,18044,0,
3433500,Lia Schorr Institute Of Cosmetic Skin Care Training,NY,16952,0,0,16952,0,
4273200,Berkowits School Of Electrolysis,NY,16632,0,0,16632,0,
4219700,Gemini School Of Visual Arts & Communication,TX,16326,0,0,16326,0,
2267600,Sofia University,CA,16303,0,0,16303,0,
3729300,New Hampshire Institute For Therapeutic Arts,NH,16274,0,0,16274,0,
842400,La' James International College,IA,15386,0,0,15386,0,
4276800,Kck Beauty & Barber Academy,FL,15023,0,0,15023,0,
4234400,American Institute Of Alternative Medicine,NJ,14814,0,0,14814,0,
598700,Avera Sacred Heart Hospital School Of Radiologic Technology,SD,6983,7599,0,14582,0,
3735300,Institute Of Clinical Acupuncture And Oriental Medicine,HI,14549,0,0,14549,0,
4125100,Montessori Casa International,CO,3492,4016,7000,14508,0,
4258200,Christina And Company Education Center,IN,14023,0,0,14023,0,
4219300,East-West Healing Arts Institute,WI,13994,0,0,13994,0,
4162000,Jose Maria Vargas University,FL,13814,0,0,13814,0,
4271100,Meridian University,CA,13758,0,0,13758,0,
3665400,Christie'S Education,NY,13385,0,0,13385,0,
4237400,Wright Graduate University For The Realization Of Human Potential,WI,5238,7786,0,13024,0,
4005300,United States University,CA,12982,0,0,12982,0,
4233200,Unilatina International College,FL,11930,0,0,11930,0,
4241900,River Valley School Of Massage,AR,11895,0,0,11895,0,
4207200,Academy Di Firenze,ID,9836,0,0,9836,0,
4248300,Los Angeles Academy Of Figurative Art,CA,9263,0,0,9263,0,
2239800,Pioneer Career And Technology Center: A Vocational School District,OH,2969,5671,0,8640,0,
4274200,Installer Institute,FL,8619,0,0,8619,0,
4118000,Byzantine Catholic Seminary Of Saints Cyril And Methodius,PA,3022,5585,0,8607,0,
4194600,Brand College,CA,8147,0,0,8147,0,
4216800,Bonnie Joseph Academy Of Cosmetology & Barbering,UT,7948,0,0,7948,0,
3695500,Arizona School Of Acupuncture And Oriental Medicine,AZ,7856,0,0,7856,0,
4275200,Dsdt,MI,7856,0,0,7856,0,
3169300,Studio Jewelers,NY,7528,0,0,7528,0,
4192500,Westchester College Of Nursing & Allied Health,CA,6110,0,0,6110,0,
4165200,Mauna Loa Helicopters,HI,6110,0,0,6110,0,
4254300,Pets Playground Grooming School,FL,5656,0,0,5656,0,
4272600,Vogue International Academy,TX,5534,0,0,5534,0,
765800,American College Of Hairstyling-Des Moines,IA,5528,0,0,5528,0,
4257800,Mobile Technical Training,NJ,5238,0,0,5238,0,
3237300,Anson College Of Cosmetology,NC,3468,0,0,3468,0,
4110300,University Of Management And Technology (The),VA,2694,0,0,2694,0,
188100,Ashford University,CA,1001,0,0,1001,0,
4124600,Professional Academy Of Cosmetology,PA,873,0,0,873,0,
3975300,Institute Of Professional Careers,NV,291,0,0,291,0,
